WDQPAMHFFCXSNU-BGABXYSRSA-N	Clofazimine
SRZNHPXWXCNNDU-IXOPCIAXSA-N	Cefotetan
RKUNBYITZUJHSG-SPUOUPEWSA-N	Atropine
QZUDBNBUXVUHMW-UHFFFAOYSA-N	Clozapine
OFVLGDICTFRJMM-WESIUVDSSA-N	Tetracycline
NCEXYHBECQHGNR-QZQOTICOSA-N	Sulfasalazine
KVWDHTXUZHCGIO-UHFFFAOYSA-N	Olanzapine
KUCQYCKVKVOKAY-CTYIDZIISA-N	Atovaquone
JQXXHWHPUNPDRT-WLSIYKJHSA-N	Rifampicin
JLYXXMFPNIAWKQ-GNIYUCBRSA-N	Lindane
JBIWCJUYHHGXTC-AKNGSSGZSA-N	Doxycycline
IWVCMVBTMGNXQD-PXOLEDIWSA-N	Oxytetracycline
GYDJEQRTZSCIOI-LJGSYFOKSA-N	Tranexamic Acid
GIJXKZJWITVLHI-PMOLBWCYSA-N	Benzatropine
ANTSCNMPPGJYLG-UHFFFAOYSA-N	Chlordiazepoxide
AAKJLRGGTJKAMG-UHFFFAOYSA-N	Erlotinib
AAOVKJBEBIDNHE-UHFFFAOYSA-N	diazepam
ABJKWBDEJIDSJZ-UHFFFAOYSA-N	butenafine
ACGUYXCXAPNIKK-UHFFFAOYSA-N	hexachlorophene
ACTRVOBWPAIOHC-UHFFFAOYSA-N	2,3-Dimercaptosuccinic acid
ACWBQPMHZXGDFX-QFIPXVFZSA-N	valsartan
ADEBPBSSDYVVLD-UHFFFAOYSA-N	donepezil
AEUTYOVWOVBAKS-UWVGGRQHSA-N	ethambutol
AGBQKNBQESQNJD-UHFFFAOYSA-N	dl-Thioctic acid
AGOYDEPGAOXOCK-KCBOHYOISA-N	clarithromycin
AHLBNYSZXLDEJQ-FWEHEUNISA-N	orlistat
AHOUBRCZNHFOSL-YOEHRIQHSA-N	paroxetine
AIONOLUJZLIMTK-AWEZNQCLSA-N	hesperetin
AIXAANGOTKPUOY-UHFFFAOYSA-N	16628-EP2280006A1
ALOBUEHUHMBRLE-UHFFFAOYSA-N	Ibutilide
ALWKGYPQUAPLQC-UHFFFAOYSA-N	NEOSTIGMINE
ANGKOCUUWGHLCE-UHFFFAOYSA-N	GLYCOPYRROLATE
ANZXOIAKUNOVQU-UHFFFAOYSA-N	Bambuterol
AOJJSUZBOXZQNB-TZSSRYMLSA-N	doxorubicin
AQHHHDLHHXJYJD-UHFFFAOYSA-N	propranolol
AQIXAKUUQRKLND-UHFFFAOYSA-N	cimetidine
AQNDDEOPVVGCPG-UHFFFAOYSA-N	ESMOLOL
ARAIBEBZBOPLMB-UFGQHTETSA-N	ZINC03918138
ASUTZQLVASHGKV-JDFRZJQESA-N	galanthamine
ATALOFNDEOCMKK-OITMNORJSA-N	Aprepitant
AUYYCJSJGJYCDS-LBPRGKRZSA-N	L-triiodothyronine
AUZONCFQVSMFAP-UHFFFAOYSA-N	disulfiram
AVKUERGKIZMTKX-NJBDSQKTSA-N	AMPICILLIN SODIUM
AVOLMBLBETYQHX-UHFFFAOYSA-N	ETHACRYNIC ACID
AXRYRYVKAWYZBR-GASGPIRDSA-N	Atazanavir
AYXYPKUFHZROOJ-ZETCQYMHSA-N	Pregabalin
BCEHBSKCWLPMDN-MGPLVRAMSA-N	Voriconazole
BCFGMOOMADDAQU-UHFFFAOYSA-N	Lapatinib
BCGWQEUPMDMJNV-UHFFFAOYSA-N	imipramine
BFSMGDJOXZAERB-UHFFFAOYSA-N	Dabrafenib
BFYIZQONLCFLEV-DAELLWKTSA-N	EXEMESTANE
BGDKAVGWHJFAGW-UHFFFAOYSA-N	tropicamide
BGRJTUBHPOOWDU-UHFFFAOYSA-N	sulpiride
BHQCQFFYRZLCQQ-OELDTZBJSA-N	cholic acid
BKRGVLQUQGGVSM-KBXCAEBGSA-N	LISURIDE
BKXVVCILCIUCLG-UHFFFAOYSA-N	CHEBI:50740
BLFQGGGGFNSJKA-XHXSRVRCSA-N	AC1Q1SY4
BLGXFZZNTVWLAY-SCYLSFHTSA-N	Yohimbine
BLSQLHNBWJLIBQ-OZXSUGGESA-N	terconazole
BLXXJMDCKKHMKV-UHFFFAOYSA-N	nabumetone
BNRNXUUZRGQAQC-UHFFFAOYSA-N	sildenafil
BOEGTKLJZSQCCD-UEKVPHQBSA-N	cefadroxil
BPEGJWRSRHCHSN-UHFFFAOYSA-N	temozolomide
BPQMGSKTAYIVFO-UHFFFAOYSA-N	Vismodegib
BPRHUIZQVSMCRT-VEUZHWNKSA-N	Rosuvastatin
BPZSYCZIITTYBL-YJYMSZOUSA-N	Arformoterol
BQJCRHHNABKAKU-KBQPJGBKSA-N	morphine
BRUQQQPBMZOVGD-XFKAJCMBSA-N	oxycodone
BSYNRYMUTXBXSQ-UHFFFAOYSA-N	aspirin
BUGYDGFZZOZRHP-UHFFFAOYSA-N	memantine
BWPIARFWQZKAIA-UHFFFAOYSA-N	protriptyline
BXKDSDJJOVIHMX-UHFFFAOYSA-N	Edrophonium chloride
BXZVVICBKDXVGW-NKWVEPMBSA-N	didanosine
BYBLEWFAAKGYCD-UHFFFAOYSA-N	miconazole
BYPFEZZEUUWMEJ-UHFFFAOYSA-N	pentoxifylline
BZKPWHYZMXOIDC-UHFFFAOYSA-N	acetazolamide
CBPNZQVSJQDFBE-FUXHJELOSA-N	Temsirolimus
CBQGYUDMJHNJBX-OALUTQOASA-N	Reboxetine
CBVCZFGXHXORBI-PXQQMZJSSA-N	indinavir
CDOZDBSBBXSXLB-UHFFFAOYSA-N	ethopropazine
CEMAWMOMDPGJMB-UHFFFAOYSA-N	oxprenolol
CEUORZQYGODEFX-UHFFFAOYSA-N	Aripiprazole
CGIGDMFJXJATDK-UHFFFAOYSA-N	indomethacin
CJBJHOAVZSMMDJ-HEXNFIEUSA-N	Darunavir
CJOFXWAVKWHTFT-XSFVSMFZSA-N	fluvoxamine
CMWTZPSULFXXJA-VIFPVBQESA-N	NAPROXEN
COVZYZSDYWQREU-UHFFFAOYSA-N	busulfan
CTENFNNZBMHDDG-UHFFFAOYSA-N	AKOS015890746
CTETYYAZBPJBHE-UHFFFAOYSA-N	haloprogin
CTRLABGOLIVAIY-UHFFFAOYSA-N	OXCARBAZEPINE
CUIHSIWYWATEQL-UHFFFAOYSA-N	Pazopanib
CURUTKGFNZGFSE-UHFFFAOYSA-N	dicyclomine
CXOFVDLJLONNDW-UHFFFAOYSA-N	phenytoin
CYQFCXCEBYINGO-IAGOWNOFSA-N	Dronabinol
CYXKNKQEMFBLER-UHFFFAOYSA-N	PERHEXILINE
CZFFBEXEKNGXKS-UHFFFAOYSA-N	Raltegravir
DBABZHXKTCFAPX-UHFFFAOYSA-N	probenecid
DBEPLOCGEIEOCV-WSBQPABSSA-N	finasteride
DBGIVFWFUFKIQN-VIFPVBQESA-N	(S)-Fenfluramine
DCOPUUMXTXDBNB-UHFFFAOYSA-N	diclofenac
DDLIGBOFAVUZHB-UHFFFAOYSA-N	midazolam
DDUHZTYCFQRHIY-RBHXEPJQSA-N	griseofulvin
DEIYFTQMQPDXOT-UHFFFAOYSA-N	Sildenafil citrate
DERZBLKQOCDDDZ-JLHYYAGUSA-N	cinnarizine
DGBIGWXXNGSACT-UHFFFAOYSA-N	clonazepam
DHMQDGOQFOQNFH-UHFFFAOYSA-N	2-azaniumylacetate
DJBNUMBKLMJRSA-UHFFFAOYSA-N	flecainide
DJDFFEBSKJCGHC-UHFFFAOYSA-N	LT00233108
DKJJVAGXPKPDRL-UHFFFAOYSA-N	Tiludronic Acid
DKNWSYNQZKUICI-UHFFFAOYSA-N	amantadine
DKYWVDODHFEZIM-UHFFFAOYSA-N	ketoprofen
DLGOEMSEDOSKAD-UHFFFAOYSA-N	carmustine
DMDGGSIALPNSEE-UHFFFAOYSA-N	hydroflumethiazide
DNXHEGUUPJUMQT-CBZIJGRNSA-N	estrone
DOBMPNYZJYQDGZ-UHFFFAOYSA-N	dicumarol
DOMXUEMWDBAQBQ-WEVVVXLNSA-N	terbinafine
DOUYETYNHWVLEO-UHFFFAOYSA-N	IMIQUIMOD
DPWPWRLQFGFJFI-UHFFFAOYSA-N	pargyline
DQCKKXVULJGBQN-XFWGSAIBSA-N	naltrexone
DRLFMBDRBRZALE-UHFFFAOYSA-N	Melatonin
DTOSIQBPPRVQHS-PDBXOOCHSA-N	linolenic acid
DUGOZIWVEXMGBE-CHWSQXEVSA-N	Dexmethylphenidate
DUGOZIWVEXMGBE-UHFFFAOYSA-N	methylphenidate
DWKVCQXJYURSIQ-UHFFFAOYSA-N	Dronedarone hydrochloride
DXGLGDHPHMLXJC-UHFFFAOYSA-N	oxybenzone
DZZWHBIBMUVIIW-DTORHVGOSA-N	ZINC00538362
FABPRXSRWADJSP-MEDUHNTESA-N	moxifloxacin
FAEKWTJYAYMJKF-QHCPKHFHSA-N	Repaglinide
FAIIFDPAEUKBEP-UHFFFAOYSA-N	nilvadipine
FAKRSMQSSFJEIM-RQJHMYQMSA-N	captopril
FAOZLTXFLGPHNG-KNAQIMQKSA-N	fluorometholone
FASDKYOPVNHBLU-ZETCQYMHSA-N	pramipexole
FBOZXECLQNJBKD-ZDUSSCGKSA-N	methotrexate
FDDDEECHVMSUSB-UHFFFAOYSA-N	sulfanilamide
FEBLZLNTKCEFIT-VSXGLTOVSA-N	FLUOCINOLONE ACETONIDE
FELGMEQIXOGIFQ-UHFFFAOYSA-N	ondansetron
FFGPTBGBLSHEPO-UHFFFAOYSA-N	carbamazepine
FGXWKSZFVQUSTL-UHFFFAOYSA-N	domperidone
FIAFUQMPZJWCLV-UHFFFAOYSA-N	AC1N6JXL
FJLBFSROUSIWMA-UHFFFAOYSA-N	metyrapone
FMHHVULEAZTJMA-UHFFFAOYSA-N	trioxsalen
FNHKPVJBJVTLMP-UHFFFAOYSA-N	Regorafenib
FNYLWPVRPXGIIP-UHFFFAOYSA-N	triamterene
FNYQZOVOVDSGJH-UHFFFAOYSA-N	Alosetron HCl
FOHHNHSLJDZUGQ-UHFFFAOYSA-N	Halofantrine
FTALBRSUTCGOEG-UHFFFAOYSA-N	riluzole
FUSNMLFNXJSCDI-UHFFFAOYSA-N	tolnaftate
FYPMFJGVHOHGLL-UHFFFAOYSA-N	probucol
FZNCGRZWXLXZSZ-CIQUZCHMSA-N	voglibose
GBBBPWVJGMFZGX-UHFFFAOYSA-N	Cimadronate
GBXSMTUPTTWBMN-XIRDDKMYSA-N	ZINC03791297
GCKMFJBGXUYNAG-HLXURNFRSA-N	methyltestosterone
GDLIGKIOYRNHDA-UHFFFAOYSA-N	clomipramine
GFBKORZTTCHDGY-UWVJOHFNSA-N	thiothixene
GFFGJBXGBJISGV-UHFFFAOYSA-N	adenine
GFNANZIMVAIWHM-OBYCQNJPSA-N	triamcinolone
GGCSSNBKKAUURC-UHFFFAOYSA-N	SUFENTANIL
GHASVSINZRGABV-UHFFFAOYSA-N	5-Fluorouracil
GHXZTYHSJHQHIJ-UHFFFAOYSA-N	SCHEMBL9931995
GIIZNNXWQWCKIB-UHFFFAOYSA-N	Salmeterol
GJJFMKBJSRMPLA-DZGCQCFKSA-N	Levomilnacipran
GJJFMKBJSRMPLA-HIFRSBDPSA-N	Milnacipran
GJPICJJJRGTNOD-UHFFFAOYSA-N	Bosentan
GJSURZIOUXUGAL-UHFFFAOYSA-N	clonidine
GKIRPKYJQBWNGO-OCEACIFDSA-N	Enclomiphene
GKTWGGQPFAXNFI-HNNXBMFYSA-N	clopidogrel
GLVAUDGFNGKCSF-UHFFFAOYSA-N	6-Mercaptopurine
GMRQFYUYWCNGIN-NKMMMXOESA-N	calcitriol
GMVPRGQOIOIIMI-DWKJAMRDSA-N	alprostadil
GOEMGAFJFRBGGG-UHFFFAOYSA-N	acebutolol
GPKJTRJOBQGKQK-UHFFFAOYSA-N	quinacrine
GPRBEKHLDVQUJE-QSWIMTSFSA-N	cefotaxime
GPXBXXGIAQBQNI-UHFFFAOYSA-N	Vemurafenib
GSDSWSVVBLHKDQ-JTQLQIEISA-N	ZINC00538273
GTTBEUCJPZQMDZ-UHFFFAOYSA-N	CHEBI:53509
GVEZIHKRYBHEFX-NQQPLRFYSA-N	cerulenin
GXDALQBWZGODGZ-UHFFFAOYSA-N	astemizole
GXJABQQUPOEUTA-RDJZCZTQSA-N	Bortezomib
GZKLJWGUPQBVJQ-UHFFFAOYSA-N	SERTINDOLE
GZOSMCIZMLWJML-VJLLXTKPSA-N	Abiraterone
GZUITABIAKMVPG-UHFFFAOYSA-N	raloxifene
HBOMLICNUCNMMY-XLPZGREQSA-N	zidovudine
HCYAFALTSJYZDH-UHFFFAOYSA-N	desipramine
HDACQVRGBOVJII-JBDAPHQKSA-N	ramipril
HEFNNWSXXWATRW-UHFFFAOYSA-N	ibuprofen
HEMJJKBWTPKOJG-UHFFFAOYSA-N	gemfibrozil
HFNKQEVNSGCOJV-OAHLLOKOSA-N	Ruxolitinib
HHZIURLSWUIHRB-UHFFFAOYSA-N	Nilotinib
HMJIYCCIJYRONP-UHFFFAOYSA-N	isradipine
HOBAELRKJCKHQD-QNEBEIHSSA-N	Dihomo-gamma-linolenic acid
HPJKCIUCZWXJDR-UHFFFAOYSA-N	letrozole
HPNSFSBZBAHARI-RUDMXATFSA-N	mycophenolic acid
HSMNQINEKMPTIC-UHFFFAOYSA-N	aminohippuric acid
HSUGRBWQSSZJOP-RTWAWAEBSA-N	diltiazem
HTIQEAQVCYTUBX-UHFFFAOYSA-N	amlodipine
HTQMVQVXFRQIKW-UHFFFAOYSA-N	candesartan
HUPFGZXOMWLGNK-UHFFFAOYSA-N	diflunisal
HWHLPVGTWGOCJO-UHFFFAOYSA-N	trihexyphenidyl
HYAFETHFCAUJAY-UHFFFAOYSA-N	Pioglitazone
HYIMSNHJOBLJNT-UHFFFAOYSA-N	nifedipine
HYYBABOKPJLUIN-UHFFFAOYSA-N	mefenamic acid
HZZVJAQRINQKSD-PBFISZAISA-N	CLAVULANIC ACID
IAIWVQXQOWNYOU-FPYGCLRLSA-N	nitrofurazone
IBAQFPQHRJAVAV-ULAWRXDQSA-N	MIGLITOL
ICFJFFQQTFMIBG-UHFFFAOYSA-N	PHENFORMIN
IDBPHNDTYPBSNI-UHFFFAOYSA-N	ALFENTANIL
IDYZIJYBMGIQMJ-UHFFFAOYSA-N	ZINC19594549
IEDVJHCEMCRBQM-UHFFFAOYSA-N	trimethoprim
IENZQIKPVFGBNW-UHFFFAOYSA-N	prazosin
IFKLAQQSCNILHL-QHAWAJNXSA-N	butorphanol
IIDJRNMFWXDHID-UHFFFAOYSA-N	Risedronic acid
IKENVDNFQMCRTR-UHFFFAOYSA-N	Conivaptan
IMONTRJLAWHYGT-ZCPXKWAGSA-N	Norethisterone acetate
INDBQLZJXZLFIT-UHFFFAOYSA-N	PRIMAQUINE
INJOMKTZOLKMBF-UHFFFAOYSA-N	GUANFACINE
IOVGROKTTNBUGK-SJCJKPOMSA-N	ritodrine
IPVQLZZIHOAWMC-QXKUPLGCSA-N	PERINDOPRIL
IQPSEEYGBUAQFF-UHFFFAOYSA-N	pantoprazole
ISFHAYSTHMVOJR-UHFFFAOYSA-N	Phenindamine
ITPDYQOUSLNIHG-UHFFFAOYSA-N	AC1LCW5V
ITRJWOMZKQRYTA-RFZYENFJSA-N	CORTISONE ACETATE
IUBSYMUCCVWXPE-UHFFFAOYSA-N	metoprolol
IVDHYUQIDRJSTI-UHFFFAOYSA-N	SCHEMBL19322
IVHBBMHQKZBJEU-UHFFFAOYSA-N	AC1LCWGP
IVLVTNPOHDFFCJ-UHFFFAOYSA-N	FENTANYL CITRATE
IVTVGDXNLFLDRM-HNNXBMFYSA-N	Raltitrexed
IWUCXVSUMQZMFG-AFCXAGJDSA-N	ribavirin
IXHBTMCLRNMKHZ-LBPRGKRZSA-N	LEVOBUNOLOL
IXTMWRCNAAVVAI-UHFFFAOYSA-N	Dofetilide
IYGXEHDCSOYNKY-RZHHZEQLSA-N	HMS3648P03
IYIKLHRQXLHMJQ-UHFFFAOYSA-N	amiodarone
IZEKFCXSFNUWAM-UHFFFAOYSA-N	dipyridamole
JAQUASYNZVUNQP-USXIJHARSA-N	levorphanol
JAUOIFJMECXRGI-UHFFFAOYSA-N	Desloratadine
JAZBEHYOTPTENJ-JLNKQSITSA-N	Eicosapentaenoic acid
JCCNYMKQOSZNPW-UHFFFAOYSA-N	loratadine
JCKYGMPEJWAADB-UHFFFAOYSA-N	chlorambucil
JFJZZMVDLULRGK-URLMMPGGSA-O	tubocurarine
JFPVXVDWJQMJEE-IZRZKJBUSA-N	cefuroxime
JGSARLDLIJGVTE-MBNYWOFBSA-N	penicillin g
JHVAMHSQVVQIOT-MFAJLEFUSA-N	Anidulafungin
JIVPVXMEBJLZRO-UHFFFAOYSA-N	chlorthalidone
JIVSXRLRGOICGA-UHFFFAOYSA-N	CHEBI:8460
JJCFRYNCJDLXIK-UHFFFAOYSA-N	CYPROHEPTADINE
JKKFKPJIXZFSSB-CBZIJGRNSA-N	Estrone sulfate
JKOQGQFVAUAYPM-UHFFFAOYSA-N	amifostine
JLKIGFTWXXRPMT-UHFFFAOYSA-N	sulfamethoxazole
JNTOCHDNEULJHD-UHFFFAOYSA-N	penciclovir
JOFWLTCLBGQGBO-UHFFFAOYSA-N	triazolam
JRURYQJSLYLRLN-BJMVGYQFSA-N	ENTACAPONE
JRWZLRBJNMZMFE-UHFFFAOYSA-N	dobutamine
JSDRRTOADPPCHY-HSQYWUDLSA-N	ZINC03801163
JSWZEAMFRNKZNL-UHFFFAOYSA-N	alosetron
JUKPWJGBANNWMW-VWBFHTRKSA-N	Eplerenone
JWBOIMRXGHLCPP-UHFFFAOYSA-N	mitotane
JWHAUXFOSRPERK-UHFFFAOYSA-N	propafenone
JWZZKOKVBUJMES-UHFFFAOYSA-N	isoproterenol
JYGXADMDTFJGBT-VWUMJDOOSA-N	hydrocortisone
JYIKNQVWKBUSNH-OGZDCFRISA-N	Caspofungin
JZCPYUJPEARBJL-UHFFFAOYSA-N	Rimonabant
JZFPYUNJRRFVQU-UHFFFAOYSA-N	niflumic acid
JZQKKSLKJUAGIC-UHFFFAOYSA-N	pindolol
JZRWCGZRTZMZEH-UHFFFAOYSA-N	thiamine
KBOPZPXVLCULAV-UHFFFAOYSA-N	5-Aminosalicylic acid
KBUZBQVCBVDWKX-UHFFFAOYSA-N	emedastine
KCLANYCVBBTKTO-UHFFFAOYSA-N	proparacaine
KCXVZYZYPLLWCC-UHFFFAOYSA-N	AC1NR0SS
KDYFGRWQOYBRFD-UHFFFAOYSA-N	succinic acid
KGFYHTZWPPHNLQ-AWEZNQCLSA-N	Rivaroxaban
KHOITXIGCFIULA-UHFFFAOYSA-N	bisacodyl
KHPKQFYUPIUARC-UHFFFAOYSA-N	Lumiracoxib
KJADKKWYZYXHBB-XBWDGYHZSA-N	topiramate
KJHKTHWMRKYKJE-SUGCFTRWSA-N	Lopinavir
KKGQTZUTZRNORY-UHFFFAOYSA-N	Fingolimod
KKZJGLLVHKMTCM-UHFFFAOYSA-N	mitoxantrone
KLBQZWRITKRQQV-UHFFFAOYSA-N	thioridazine
KPHWPUGNDIVLNH-UHFFFAOYSA-M	Diclofenac sodium
KPYSYYIEGFHWSV-UHFFFAOYSA-N	baclofen
KQKPFRSPSRPDEB-UHFFFAOYSA-N	sumatriptan
KQPKPCNLIDLUMF-UHFFFAOYSA-N	secobarbital
KRMDCWKBEZIMAB-UHFFFAOYSA-N	amitriptyline
KTEIFNKAUNYNJU-GFCCVEGCSA-N	Crizotinib
KTUFNOKKBVMGRW-UHFFFAOYSA-N	Imatinib
KUVIULQEHSCUHY-XYWKZLDCSA-N	BECLOMETHASONE DIPROPIONATE
KWTSXDURSIMDCE-QMMMGPOBSA-N	dextroamphetamine
KWTSXDURSIMDCE-UHFFFAOYSA-N	AMPHETAMINE
KYYIDSXMWOZKMP-UHFFFAOYSA-N	Desvenlafaxine
LALFOYNTGMUKGG-BGRFNVSISA-L	Ambap147098-18-8
LEBVLXFERQHONN-INIZCTEOSA-N	Levobupivacaine
LEZWWPYKPKIXLL-UHFFFAOYSA-N	econazole
LHHCSNFAOIFYRV-DOVBMPENSA-N	Boceprevir
LIRYPHYGHXZJBZ-UHFFFAOYSA-N	Trametinib
LKJPYSCBVHEWIU-UHFFFAOYSA-N	bicalutamide
LNEPOXFFQSENCJ-UHFFFAOYSA-N	haloperidol
LOUPRKONTZGTKE-WZBLMQSHSA-N	Quinine
LPMXVESGRSUGHW-HBYQJFLCSA-N	ouabain
LPQZKKCYTLCDGQ-WEDXCCLWSA-N	Tazobactam
LQCLVBQBTUVCEQ-QTFUVMRISA-N	TROLEANDOMYCIN
LQOLIRLGBULYKD-JKIFEVAISA-N	cloxacillin
LSLYOANBFKQKPT-UHFFFAOYSA-N	fenoterol
LSQZJLSUYDQPKJ-NJBDSQKTSA-N	ZINC03830215
LTMHDMANZUZIPE-PUGKRICDSA-N	digoxin
LTXREWYXXSTFRX-QGZVFWFLSA-N	Linagliptin
LUALIOATIOESLM-UHFFFAOYSA-N	periciazine
LUZRJRNZXALNLM-JGRZULCMSA-N	dihydroergotamine
LXMSZDCAJNLERA-ZHYRCANASA-N	spironolactone
MBGGBVCUIVRRBF-UHFFFAOYSA-N	sulfinpyrazone
MBUVEWMHONZEQD-UHFFFAOYSA-N	azelastine
MDKGKXOCJGEUJW-UHFFFAOYSA-N	suprofen
MEPNHSOMXMALDZ-UHFFFAOYSA-N	DELAVIRDINE MESYLATE
METKIMKYRPQLGS-UHFFFAOYSA-N	atenolol
MFFMDFFZMYYVKS-SECBINFHSA-N	Sitagliptin
MFWNKCLOYSRHCJ-UHFFFAOYSA-N	granisetron
MIQPIUSUKVNLNT-UHFFFAOYSA-N	Tolcapone
MJFJKKXQDNNUJF-UHFFFAOYSA-N	Metixene
MJIHNNLFOKEZEW-UHFFFAOYSA-N	lansoprazole
MJVAVZPDRWSRRC-UHFFFAOYSA-N	menadione
MKXKFYHWDHIYRV-UHFFFAOYSA-N	flutamide
MKXZASYAUGDDCJ-NJAFHUGGSA-N	dextromethorphan
MLDQJTXFUGDVEO-UHFFFAOYSA-N	Sorafenib
MLKXDPUZXIRXEP-MFOYZWKCSA-N	sulindac
MNDBXUUTURYVHR-UHFFFAOYSA-N	Roflumilast
MNJVRJDLRVPLFE-UHFFFAOYSA-N	Etoricoxib
MPBVHIBUJCELCL-UHFFFAOYSA-N	Ibandronic Acid
MQJKPEGWNLWLTK-UHFFFAOYSA-N	dapsone
MQTOSJVFKKJCRP-BICOPXKESA-N	azithromycin
MRBDMNSDAVCSSF-UHFFFAOYSA-N	phentolamine
MUCZHBLJLSDCSD-UHFFFAOYSA-N	Isoflurophate
MUMGGOZAMZWBJJ-DYKIIFRCSA-N	testosterone
MVWVFYHBGMAFLY-UHFFFAOYSA-N	Ziprasidone
MWLSOWXNZPKENC-UHFFFAOYSA-N	ZILEUTON
MYSWGUAQZAJSOK-UHFFFAOYSA-N	ZINC00020220
NCDNCNXCDXHOMX-XGKFQTDJSA-N	ritonavir
NDAUXUAQIAJITI-UHFFFAOYSA-N	Salbutamol
NDDAHWYSQHTHNT-UHFFFAOYSA-N	indapamide
NETZHAKZCGBWSS-CEDHKZHLSA-N	nalbuphine
NFDFQCUYFHCNBW-SCGPFSFSSA-N	dienestrol
NHUHCSRWZMLRLA-UHFFFAOYSA-N	sulfisoxazole
NIJJYAXOARWZEE-UHFFFAOYSA-N	VALPROIC ACID
NKANXQFJJICGDU-QPLCGJKRSA-N	tamoxifen
NNJVILVZKWQKPM-UHFFFAOYSA-N	lidocaine
NNYBQONXHNTVIJ-UHFFFAOYSA-N	etodolac
NOYPYLRCIDNJJB-UHFFFAOYSA-N	trimetrexate
NPUKDXXFDDZOKR-LLVKDONJSA-N	Etomidate
NQDJXKOVJZTUJA-UHFFFAOYSA-N	nevirapine
NWIUTZDMDHAVTP-UHFFFAOYSA-N	betaxolol
NZWOPGCLSHLLPA-UHFFFAOYSA-N	methacholine
OCAPBUJLXMYKEJ-UHFFFAOYSA-N	bifonazole
OCSMOTCMPXTDND-OUAUKWLOSA-N	Marimastat
ODKNJVUHOIMIIZ-RRKCRQDMSA-N	floxuridine
ODQWQRRAPPTVAG-BOPFTXTBSA-N	doxepin
OEKWJQXRCDYSHL-FNOIDJSQSA-N	Ticagrelor
OEYIOHPDSNJKLS-UHFFFAOYSA-N	choline
OFCNXPDARWKPPY-UHFFFAOYSA-N	allopurinol
OFHCOWSQAMBJIW-AVJTYSNKSA-N	alfacalcidol
OFPXSFXSNFPTHF-UHFFFAOYSA-N	ZINC49643479
OGAKLTJNUQRZJU-UHFFFAOYSA-N	Difenidol
OGHNVEJMJSYVRP-UHFFFAOYSA-N	carvedilol
OGSPWJRAVKPPFI-UHFFFAOYSA-N	alendronate
OGWKCGZFUXNPDA-XQKSVPLYSA-N	vincristine
OIGNJSKKLXVSLS-VWUMJDOOSA-N	prednisolone
OIRDTQYFTABQOQ-KQYNXXCUSA-N	adenosine
OIRDTQYFTABQOQ-UHTZMRCNSA-N	Vidarabine
OJCZPLDERGDQRJ-UHFFFAOYSA-N	Sufentanil citrate
OJGDCBLYJGHCIH-UHFFFAOYSA-N	bromhexine
OKBVVJOGVLARMR-QSWIMTSFSA-N	CEFIXIME
OLBCVFGFOZPWHH-UHFFFAOYSA-N	propofol
OLVCFLKTBJRLHI-AXAPSJFSSA-N	cefamandole
OMHBPUNFVFNHJK-UHFFFAOYSA-P	ambenonium
ONKUMRGIYFNPJW-KIEAKMPYSA-N	ETHYNODIOL DIACETATE
OPXLLQIJSORQAM-UHFFFAOYSA-N	mebendazole
ORFOPKXBNMVMKC-DWVKKRMSSA-N	ceftazidime
OROAFUQRIXKEMV-LDADJPATSA-N	Eprosartan
OSVMTWJCGUFAOD-KZQROQTASA-N	formestane
OSZNNLWOYWAHSS-UHFFFAOYSA-M	Neostigmine methyl sulfate
OUBCNLGXQFSTLU-UHFFFAOYSA-N	Nitisinone
OUDSBRTVNLOZBN-UHFFFAOYSA-N	tolazamide
OZVBMTJYIDMWIL-AYFBDAFISA-N	bromocriptine
OZWKMVRBQXNZKK-UHFFFAOYSA-N	ketorolac
OZYUPQUCAUTOBP-QXAKKESOSA-N	levallorphan
PBJUNZJWGZTSKL-MRXNPFEDSA-N	ZINC03831531
PCZOHLXUXFIOCF-BXMDZJJMSA-N	lovastatin
PDMMFKSKQVNJMI-BLQWBTBKSA-N	testosterone propionate
PFNFFQXMRSDOHW-UHFFFAOYSA-N	spermine
PGYPOBZJRVSMDS-UHFFFAOYSA-N	hydrogen 4-[4-(4-chlorophenyl)-4-hydroxypiperidin-1-yl]-N,N-dimethyl-2,2-diphenylbutanamide chloride
PHLBKPHSAVXXEF-UHFFFAOYSA-N	trazodone
PHVGLTMQBUFIQQ-UHFFFAOYSA-N	nortriptyline
PHWBOXQYWZNQIN-UHFFFAOYSA-N	ticlopidine
PHXJVRSECIGDHY-UHFFFAOYSA-N	PONATINIB
PIEUQSKUWLMALL-YABMTYFHSA-N	Micafungin
PIJVFDBKTWXHHD-HIFRSBDPSA-N	physostigmine
PJDFLNIOAUIZSL-UHFFFAOYSA-N	vigabatrin
PJMPHNIQZUBGLI-UHFFFAOYSA-N	fentanyl
PLDUPXSUYLZYBN-UHFFFAOYSA-N	FLUPHENAZINE
PMRYVIKBURPHAH-UHFFFAOYSA-N	methimazole
PMXMIIMHBWHSKN-UHFFFAOYSA-N	Paliperidone
PNVNVHUZROJLTJ-UHFFFAOYSA-N	venlafaxine
POPFMWWJOGLOIF-XWCQMRHXSA-N	flurandrenolide
POZRVZJJTULAOH-LHZXLZLDSA-N	danazol
PPTYJKAXVCCBDU-UHFFFAOYSA-N	flunitrazepam
PROQIPRRNZUXQM-ZXXIGWHRSA-N	estriol
PSGAAPLEWMOORI-PEINSRQWSA-N	Medroxyprogesterone acetate
PSIFNNKUMBGKDQ-UHFFFAOYSA-N	losartan
PUXBGTOOZJQSKH-UHFFFAOYSA-N	carprofen
PVHUJELLJLJGLN-UHFFFAOYSA-N	nitrendipine
PVNIIMVLHYAWGP-UHFFFAOYSA-N	nicotinic acid
PWWVAXIEGOYWEE-UHFFFAOYSA-N	promethazine
PYGWGZALEOIKDF-UHFFFAOYSA-N	Etravirine
PYTMYKVIJXPNBD-OQKDUQJOSA-N	Clomifene citrate
PYZRQGJRPPTADH-UHFFFAOYSA-N	lamotrigine
PZRHRDRVRGEVNW-UHFFFAOYSA-N	milrinone
QAGYKUNXZHXKMR-HKWSIXNMSA-N	nelfinavir
QEVHRUUCFGRFIF-MDEJGZGSSA-N	reserpine
QGJUIPDUBHWZPV-SGTAVMJGSA-N	Saxagliptin
QJJXYPPXXYFBGM-LFZNUXCKSA-N	tacrolimus
QORVDGQLPPAFRS-XPSHAMGMSA-N	FT-0668940
QOYHHIBFXOOADH-UHFFFAOYSA-N	Fluspirilene
QRXWMOHMRWLFEY-UHFFFAOYSA-N	isoniazid
QSLMDECMDJKHMQ-UHFFFAOYSA-N	maprotiline
QTAOMKOIBXZKND-PPHPATTJSA-N	Carbidopa hydrate
QVYRGXJJSLMXQH-UHFFFAOYSA-N	orphenadrine
QWCJHSGMANYXCW-UHFFFAOYSA-N	sulfaphenazole
QWCRAEMEVRGPNT-UHFFFAOYSA-N	buspirone
QWGDMFLQWFTERH-UHFFFAOYSA-N	amoxapine
QXKHYNVANLEOEG-UHFFFAOYSA-N	methoxsalen
QYIYFLOTGYLRGG-GPCCPHFNSA-N	cefaclor
QYSPLQLAKJAUJT-UHFFFAOYSA-N	piroxicam
QZVCTJOXCFMACW-UHFFFAOYSA-N	phenoxybenzamine
QZZUEBNBZAPZLX-QFIPXVFZSA-N	Indacaterol
RAPZEAPATHNIPO-UHFFFAOYSA-N	risperidone
RCINICONZNJXQF-MZXODVADSA-N	paclitaxel
RDJGLLICXDHJDY-UHFFFAOYSA-N	fenoprofen
RDOIQAHITMMDAJ-UHFFFAOYSA-N	loperamide
REEUVFCVXKWOFE-UHFFFAOYSA-K	GALLAMINE TRIETHIODIDE
REQCZEXYDRLIBE-UHFFFAOYSA-N	PROCAINAMIDE
RFWZESUMWJKKRN-UHFFFAOYSA-N	Dapiprazole
RGCVKNLCSQQDEP-UHFFFAOYSA-N	perphenazine
RGLYKWWBQGJZGM-ISLYRVAYSA-N	diethylstilbestrol
RGPDIGOSVORSAK-STHHAXOLSA-N	AKOS015896592
RHBRMCOKKKZVRY-ITLPAZOVSA-N	Naltrexone hydrochloride
RHGYHLPFVJEAOC-FFNUKLMVSA-L	ITAVASTATIN Ca
RJIWZDNTCBHXAL-UHFFFAOYSA-N	5-nitroquinolin-8-ol
RJKFOVLPORLFTN-LEKSSAKUSA-N	progesterone
RJMUSRYZPJIFPJ-UHFFFAOYSA-N	niclosamide
RLAWWYSOJDYHDC-BZSNNMDCSA-N	ZINC03812863
RMEDXOLNCUSCGS-UHFFFAOYSA-N	droperidol
RMHMFHUVIITRHF-UHFFFAOYSA-N	pirenzepine
RMMXLENWKUUMAY-UHFFFAOYSA-N	Telmisartan
RMRJXGBAOAMLHD-IHFGGWKQSA-N	buprenorphine
RMUCZJUITONUFY-UHFFFAOYSA-N	Phenelzine
RNLQIBCLLYYYFJ-UHFFFAOYSA-N	Amrinone
ROBVIMPUHSLWNV-UHFFFAOYSA-N	aminoglutethimide
RPTUSVTUFVMDQK-UHFFFAOYSA-N	hydralazine
RRGUKTPIGVIEKM-UHFFFAOYSA-N	cilostazol
RRUDCFGSUDOHDG-UHFFFAOYSA-N	acetohydroxamic acid
RTHCYVBBDHJXIQ-UHFFFAOYSA-N	fluoxetine
RTXOFQZKPXMALH-GHXIOONMSA-N	cefdinir
RUDATBOHQWOJDD-UZVSRGJWSA-N	URSODEOXYCHOLIC ACID
RUOKEQAAGRXIBM-GFCCVEGCSA-N	rasagiline
RUZYUOTYCVRMRZ-UHFFFAOYSA-N	doxazosin
RVOLLAQWKVFTGE-UHFFFAOYSA-N	pyridostigmine
RWTNPBWLLIMQHL-UHFFFAOYSA-N	fexofenadine
RXKMOPXNWTYEHI-RDRKJGRWSA-N	dihydrogen 1-[bis(4-fluorophenyl)methyl]-4-[(2E)-3-phenylprop-2-en-1-yl]piperazine dichloride
RXZBMPWDPOLZGW-XMRMVWPWSA-N	roxithromycin
RXZMMZZRUPYENV-VROPFNGYSA-N	Solifenacin succinate
RYHCACJBKCOBTJ-UHFFFAOYSA-N	ALVERINE CITRATE
RYMZZMVNJRMUDD-HGQWONQESA-N	simvastatin
RYYVLZVUVIJVGH-UHFFFAOYSA-N	caffeine
RZEKVGVHFLEQIL-UHFFFAOYSA-N	celecoxib
RZTAMFZIAATZDJ-UHFFFAOYSA-N	felodipine
RZVAJINKPMORJF-UHFFFAOYSA-N	acetaminophen
SBDNJUWAMKYJOX-UHFFFAOYSA-N	meclofenamate
SBXXSUDPJJJJLC-YDALLXLXSA-M	Cytomel
SECKRCOLJRRGGV-UHFFFAOYSA-N	Vardenafil
SESFRYSPDFLNCH-UHFFFAOYSA-N	BENZYL BENZOATE
SGEGOXDYSFKCPT-UHFFFAOYSA-N	Vilazodone
SGTNSNPWRIOYBX-UHFFFAOYSA-N	VERAPAMIL
SGUAFYQXFOLMHL-UHFFFAOYSA-N	labetalol
SGXXNSQHWDMGGP-IZZDOVSWSA-N	nizatidine
SHGAZHPCJJPHSC-XFYACQKRSA-N	Isotretinoin
SHGAZHPCJJPHSC-YCNIQYBTSA-N	Retinoic acid
SHGAZHPCJJPHSC-ZVCIMWCZSA-N	Alitretinoin
SIEYLFHKZGLBNX-NTISSMGPSA-N	Levobupivacaine hydrochloride
SKIVFJLNDNKQPD-UHFFFAOYSA-N	sulfacetamide
SKYZYDSNJIOXRL-BTQNPOSSSA-N	Apomorphine HCl
SKZKKFZAGNVIMN-UHFFFAOYSA-N	salicylamide
SLVMESMUVMCQIY-UHFFFAOYSA-N	mesoridazine
SLXKOJJOQWFEFD-UHFFFAOYSA-N	6-aminohexanoic acid
SMANXXCATUTDDT-QPJJXVBHSA-N	flunarizine
SMTZFNFIKUPEJC-UHFFFAOYSA-N	ROXATIDINE ACETATE
SNPPWIUOZRMYNY-UHFFFAOYSA-N	bupropion
SOYKEARSMXGVTM-UHFFFAOYSA-N	chlorpheniramine
SPIUTQOUKAMGCX-UHFFFAOYSA-N	flavoxate
STJMRWALKKWQGH-UHFFFAOYSA-N	clenbuterol
STQGQHZAVUOBTE-VGBVRHCVSA-N	daunorubicin
SUBDBMMJDZJVOS-UHFFFAOYSA-N	omeprazole
SYOKIDBDQMKNDQ-XWTIBIIYSA-N	Vildagliptin
SYTBZMRGLBWNTM-UHFFFAOYSA-N	flurbiprofen
SYWHXTATXSMDSB-GSLJADNHSA-N	FLUDROCORTISONE ACETATE
TTWJBBZEZQICBI-UHFFFAOYSA-N	metoclopramide
TUZYXOIXSAXUGO-PZAWKZKUSA-N	pravastatin
TYMRLRRVMHJFTF-UHFFFAOYSA-N	mafenide
TYZROVQLWOKYKF-ZDUSSCGKSA-N	linezolid
TZFWDZFKRBELIQ-UHFFFAOYSA-N	chlorzoxazone
UBCHPRBFMUDMNC-UHFFFAOYSA-N	rimantadine
UBPYILGKFZZVDX-UHFFFAOYSA-N	Bosutinib
UCFGDBYHRUNTLO-QHCPKHFHSA-N	topotecan
UCHDWCPVSPXUMX-TZIWLTJVSA-N	montelukast
UCTWMZQNUQWSLP-VIFPVBQESA-N	epinephrine
UDMBCSSLTHHNCD-KQYNXXCUSA-N	adenosine 5'-monophosphate
UEJJHQNACJXSKW-UHFFFAOYSA-N	thalidomide
UEQUQVLFIPOEMF-UHFFFAOYSA-N	mianserin
UGJMXCAKCUNAIE-UHFFFAOYSA-N	gabapentin
UHDGCWIWMRVCDJ-CCXZUQQUSA-N	cytarabine
UHSKFQJFRQCDBE-UHFFFAOYSA-N	ropinirole
UHTHHESEBZOYNR-UHFFFAOYSA-N	Vandetanib
UIAGMCDKSXEBJQ-UHFFFAOYSA-N	nimodipine
UIEATEWHFDRYRU-UHFFFAOYSA-N	bepridil
ULGZDMOVFRHVEP-RWJQBGPGSA-N	erythromycin
ULXXDDBFHOBEHA-CWDCEQMOSA-N	Afatinib
UNAANXDKBXWMLN-UHFFFAOYSA-N	sibutramine
UNBRKDKAWYKMIV-QWQRMKEZSA-N	methylergonovine
UOTMYNBWXDUBNX-UHFFFAOYSA-N	1-[(3,4-dimethoxyphenyl)methyl]-6,7-dimethoxyisoquinolin-2-ium chloride
UPNUIXSCZBYVBB-JVFUWBCBSA-N	ZINC03802417
UPSPUYADGBWSHF-UHFFFAOYSA-N	tolmetin
UQCNKQCJZOAFTQ-ISWURRPUSA-N	oxymorphone
UQRORFVVSGFNRO-UTINFBMNSA-N	Miglustat
UREBDLICKHMUKA-CXSFZGCWSA-N	dexamethasone
UREBDLICKHMUKA-DVTGEIKXSA-N	betamethasone
URKOMYMAXPYINW-UHFFFAOYSA-N	quetiapine
USSIQXCVUWKGNF-UHFFFAOYSA-N	methadone
UUOJIACWOAYWEZ-UHFFFAOYSA-N	BOPINDOLOL
UUVWYPNAQBNQJQ-UHFFFAOYSA-N	altretamine
UVKZSORBKUEBAZ-UHFFFAOYSA-N	CYCLIZINE
UWKQSNNFCGGAFS-XIFFEERXSA-N	irinotecan
UYIFTLBWAOGQBI-BZDYCCQFSA-N	estradiol benzoate
UZHSEJADLWPNLE-GRGSLBFTSA-N	naloxone
VAAUVRVFOQPIGI-SPQHTLEESA-N	ceftriaxone
VCKUSRYTPJJLNI-UHFFFAOYSA-N	terazosin
VGKDLMBJGBXTGI-SJCJKPOMSA-N	sertraline
VHGCDTVCOLNTBX-QGZVFWFLSA-N	Atomoxetine
VHOGYURTWQBHIL-UHFFFAOYSA-N	leflunomide
VHRSUDSXCMQTMA-PJHHCJLFSA-N	methylprednisolone
VHVPQPYKVGDNFY-ZPGVKDDISA-N	itraconazole
VIKNJXKGJWUCNN-XGXHKTLJSA-N	norethindrone
VJJPUSNTGOMMGY-MRVIYFEKSA-N	etoposide
VKHAHZOOUSRJNA-GCNJZUOMSA-N	mifepristone
VKQFCGNPDRICFG-UHFFFAOYSA-N	nisoldipine
VLPIATFUUWWMKC-UHFFFAOYSA-N	Mexiletine
VMWNQDUVQKEIOC-CYBMUJFWSA-N	apomorphine
VNFPBHJOKIVQEB-UHFFFAOYSA-N	clotrimazole
VNYBTNPBYXSMOO-UHFFFAOYSA-M	Kalymin
VOVIALXJUBGFJZ-KWVAZRHASA-N	budesonide
VOXZDWNPVJITMN-ZBRFXRBCSA-N	estradiol
VPPJLAIAVCUEMN-GFCCVEGCSA-N	Lacosamide
VRBKIVRKKCLPHA-UHFFFAOYSA-N	nefazodone
VREFGVBLTWBCJP-UHFFFAOYSA-N	alprazolam
VSQQQLOSPVPRAZ-RRKCRQDMSA-N	Trifluridine
VSZGPKBBMSAYNT-RRFJBIMHSA-N	oseltamivir
VTRAEEWXHOVJFV-UHFFFAOYSA-N	Olmesartan
VUFGUVLLDPOSBC-XRZFDKQNSA-M	CEPHALOTHIN SODIUM
VWFCHDSQECPREK-LURJTMIESA-N	Cidofovir
VWVSBHGCDBMOOT-IIEHVVJPSA-N	desoximetasone
VYFYYTLLBUKUHU-UHFFFAOYSA-N	dopamine
VYMDGNCVAMGZFE-UHFFFAOYSA-N	phenylbutazone
VYQNWZOUAUKGHI-UHFFFAOYSA-N	4-Benzyloxyphenol
WAEXFXRVDQXREF-UHFFFAOYSA-N	Vorinostat
WDFKMLRRRCGAKS-UHFFFAOYSA-N	chloroxine
WDJUZGPOPHTGOT-XUDUSOBPSA-N	digitoxin
WDZVGELJXXEGPV-YIXHJXPBSA-N	guanabenz
WESWYMRNZNDGBX-YLCXCWDSSA-N	Mefloquine hydrochloride
WEXRUCMBJFQVBZ-UHFFFAOYSA-N	pentobarbital
WFXFYZULCQKPIP-UHFFFAOYSA-N	Prazosin hydrochloride
WHBIGIKBNXZKFE-UHFFFAOYSA-N	Delavirdine
WHTVZRBIWZFKQO-UHFFFAOYSA-N	chloroquine
WHWZLSFABNNENI-UHFFFAOYSA-N	epinastine
WIKYUJGCLQQFNW-UHFFFAOYSA-N	prochlorperazine
WIMWMKZEIBHDTH-UHFFFAOYSA-N	MolPort-000-731-151
WINHZLLDWRZWRT-ATVHPVEESA-N	Sunitinib
WJCNZQLZVWNLKY-UHFFFAOYSA-N	thiabendazole
WJOHZNCJWYWUJD-IUGZLZTKSA-N	fluocinonide
WKRLQDKEXYKHJB-HFTRVMKXSA-N	equilin
WKSAUQYGYAYLPV-UHFFFAOYSA-N	pyrimethamine
WMWTYOKRWGGJOA-CENSZEJFSA-N	FLUTICASONE PROPIONATE
WOXKDUGGOYFFRN-IIBYNOLFSA-N	Tadalafil
WRUUGTRCQOWXEG-UHFFFAOYSA-N	PAMIDRONIC ACID
WSEQXVZVJXJVFP-FQEVSTJZSA-N	Escitalopram
WSEQXVZVJXJVFP-UHFFFAOYSA-N	citalopram
WTDRDQBEARUVNC-LURJTMIESA-N	levodopa
WVVSZNPYNCNODU-XTQGRXLLSA-N	Ergometrine
WXCXUHSOUPDCQV-UHFFFAOYSA-N	Enzalutamide
WYDUSKDSKCASEF-UHFFFAOYSA-N	procyclidine
WYWHKKSPHMUBEB-UHFFFAOYSA-N	6-Thioguanine
WYWIFABBXFUGLM-UHFFFAOYSA-N	oxymetazoline
WZNJWVWKTVETCG-YFKPBYRVSA-N	L-mimosine
WZPBZJONDBGPKJ-VEHQQRBSSA-N	aztreonam
XADCESSVHJOZHK-UHFFFAOYSA-N	meperidine
XCGSFFUVFURLIX-VFGNJEKYSA-N	ERGOTAMINE
XCPGHVQEEXUHNC-UHFFFAOYSA-N	amsacrine
XDRYMKDFEDOLFX-UHFFFAOYSA-N	pentamidine
XEEQGYMUWCZPDN-UHFFFAOYSA-N	Lariam
XEFQLINVKFYRCS-UHFFFAOYSA-N	triclosan
XEYBRNLFEZDVAW-ARSRFYASSA-N	Prostaglandin E2
XFDJYSQDBULQSI-UHFFFAOYSA-N	doxapram
XGALLCVXEZPNRQ-UHFFFAOYSA-N	Gefitinib
XIQVNETUBQGFHX-UHFFFAOYSA-N	oxybutynin
XIURVHNZVLADCM-IUODEOHRSA-N	cephalothin
XLAKJQPTOJHYDR-QTQXQZBYSA-M	Aclidinium bromide
XOFYZVNMUHMLCC-ZPOLXVRWSA-N	prednisone
XPCFTKFZXHTYIP-PMACEKPBSA-N	benazepril
XPOQHMRABVBWPR-ZDUSSCGKSA-N	efavirenz
XQFRJNBWHJMXHO-RRKCRQDMSA-N	idoxuridine
XQYZDYMELSJDRZ-UHFFFAOYSA-N	papaverine
XRASPMIURGNCCH-UHFFFAOYSA-N	Zoledronic acid
XSCGXQMFQXDFCW-UHFFFAOYSA-N	triflupromazine
XSDQTOBWRPYKKA-UHFFFAOYSA-N	AMILORIDE
XSFJVAJPIHIPKU-XWCQMRHXSA-N	flunisolide
XSVMFMHYUFZWBK-NSHDSACASA-N	rivastigmine
XTNGUQKDFGDXSJ-ZXGKGEBGSA-N	Canagliflozin
XTULMSXFIHGYFS-VLSRWLAYSA-N	Avamys
XUBOMFCQGDBHNK-UHFFFAOYSA-N	AC1NJHTG
XUFQPHANEAPEMJ-UHFFFAOYSA-N	famotidine
XUIIKFGFIJCVMT-LBPRGKRZSA-N	CHEBI:58448
XXSMGPRMXLTPCZ-UHFFFAOYSA-N	hydroxychloroquine
XYLJNLCSTIOKRM-UHFFFAOYSA-N	brimonidine
YBBLVLTVTVSKRW-UHFFFAOYSA-N	anastrozole
YECBIJXISLIIDS-UHFFFAOYSA-N	pyrilamine
YEEZWCHGZNKEEK-UHFFFAOYSA-N	zafirlukast
YEHCICAEULNIGD-MZMPZRCHSA-N	pergolide
YFGHCGITMMYXAQ-UHFFFAOYSA-N	modafinil
YGSDEFSMJLZEOE-UHFFFAOYSA-N	salicylic acid
YHXISWVBGDMDLQ-UHFFFAOYSA-N	moclobemide
YIQPUIGJQJDJOS-UHFFFAOYSA-N	Plerixafor
YLMAHDNUQAMNNX-UHFFFAOYSA-N	SCHEMBL15632914
YLRFCQOZQXIBAB-RBZZARIASA-N	fluoxymesterone
YMARZQAQMVYCKC-OEMFJLHTSA-N	amprenavir
YMDXZJFXQJVXBF-STHAYSLISA-N	FOSFOMYCIN
YMTINGFKWWXKFG-UHFFFAOYSA-N	fenofibrate
YNNUSGIPVFPVBX-NHCUHLMSSA-N	clemastine
YQEZLKZALYSWHR-UHFFFAOYSA-N	ketamine
YREYEVIYCVEVJK-UHFFFAOYSA-N	rabeprazole
YVUQSNJEYSNKRX-UHFFFAOYSA-N	pimozide
ZAFYATHCZYHLPB-UHFFFAOYSA-N	zolpidem
ZAHQPTJLOCWVPG-UHFFFAOYSA-N	Mitoxantrone dihydrochloride
ZBBHBTPTTSWHBA-UHFFFAOYSA-N	nicardipine
ZBMZVLHSJCTVON-UHFFFAOYSA-N	sotalol
ZBNZXTGUTAYRHI-UHFFFAOYSA-N	Dasatinib
ZBPLOVFIXSTCRZ-UHFFFAOYSA-N	Bromfenac
ZCVMWBYGMWKGHF-UHFFFAOYSA-N	ketotifen
ZDIGNSYAACHWNL-UHFFFAOYSA-N	BROMPHENIRAMINE
ZDZOTLJHXYCWBA-VCVYQWHSSA-N	docetaxel
ZEUITGRIYCTCEM-KRWDZBQOSA-N	duloxetine
ZEWQUBUPAILYHI-UHFFFAOYSA-N	trifluoperazine
ZFXYFBGIUFBOJW-UHFFFAOYSA-N	theophylline
ZGUGWUXLJSTTMA-UHFFFAOYSA-N	promazine
ZGXJTSGNIOSYLO-UHFFFAOYSA-N	5-ammonio-4-oxopentanoate
ZJAOAACCNHFJAH-UHFFFAOYSA-N	foscarnet
ZJVFLBOZORBYFE-UHFFFAOYSA-N	ibudilast
ZKLPARSLTMPFCP-UHFFFAOYSA-N	cetirizine
ZNNLBTZKUZBEKO-UHFFFAOYSA-N	glyburide
ZPAKPRAICRBAOD-UHFFFAOYSA-N	fenbufen
ZPEIMTDSQAKGNT-UHFFFAOYSA-N	chlorpromazine
ZPUCINDJVBIVPJ-LJISPDSOSA-N	cocaine
ZPXSCAKFGYXMGA-UHFFFAOYSA-N	mazindol
ZQTNQVWKHCQYLQ-UHFFFAOYSA-N	Dronedarone
ZRVUJXDFFKFLMG-UHFFFAOYSA-N	meloxicam
ZSBOMTDTBDDKMP-OAHLLOKOSA-N	Alogliptin
ZSCDBOWYZJWBIY-UHFFFAOYSA-N	trimipramine
ZSKVGTPCRGIANV-ZXFLCMHBSA-N	ZINC04097225
ZXJXZNDDNMQXFV-UHFFFAOYSA-M	Crystal violet
ZZORFUFYDOWNEF-UHFFFAOYSA-N	sulfadimethoxine
ZZUFCTLCJUWOSV-UHFFFAOYSA-N	furosemide
ZZVUWRFHKOJYTH-UHFFFAOYSA-N	diphenhydramine
VWLHWLSRQJQWRG-UHFFFAOYSA-O	edrophonium
OFBIFZUFASYYRE-UHFFFAOYSA-N	flumazenil
JBIMVDZLSHOPLA-LSCVHKIXSA-N	Olopatadine
OGJPXUAPXNRGGI-UHFFFAOYSA-N	norfloxacin
RFHAOTPXVQNOHP-UHFFFAOYSA-N	fluconazole
UBQNRHZMVUUOMG-UHFFFAOYSA-N	zonisamide
YJYPHIXNFHFHND-UHFFFAOYSA-N	Agomelatine
HCZKYJDFEPMADG-TXEJJXNPSA-N	Masoprocol
JTEGQNOMFQHVDC-NKWVEPMBSA-N	lamivudine
PCOBBVZJEWWZFR-UHFFFAOYSA-N	Retigabine
KNHUKKLJHYUCFP-UHFFFAOYSA-N	clofibrate
COLNVLDHVKWLRT-QMMMGPOBSA-N	L-phenylalanine
SIQPXVQCUCHWDI-UHFFFAOYSA-N	ENPROFYLLINE
GYHCTFXIZSNGJT-XMMPIXPASA-N	Samsca
GJQPMPFPNINLKP-UHFFFAOYSA-N	dichlorphenamide
CHIFCDOIPRCHCF-UHFFFAOYSA-N	Delorazepam
MTCUAOILFDZKCO-UHFFFAOYSA-N	decamethonium
SJZRECIVHVDYJC-UHFFFAOYSA-M	4-Hydroxybutanoate
OGQICQVSFDPSEI-UHFFFAOYSA-N	tazarotene
GECBBEABIDMGGL-RTBURBONSA-N	Nabilone
MCGSCOLBFJQGHM-SCZZXKLOSA-N	abacavir
OZOMQRBLCMDCEG-VIZOYTHASA-N	dantrolene
UMSGKTJDUHERQW-UHFFFAOYSA-N	brotizolam
COKMIXFXJJXBQG-NRFANRHFSA-N	ZINC03806104
FPVKHBSQESCIEP-JQCXWYLXSA-N	pentostatin
KXNPVXPOPUZYGB-XYVMCAHJSA-N	ZINC03807172
OLNTVTPDXPETLC-XPWALMASSA-N	Ezetimibe
FPIPGXGPPPQFEQ-OVSJKPMPSA-N	retinol
OTBXOEAOVRKTNQ-UHFFFAOYSA-N	anagrelide
XWXYUMMDTVBTOU-UHFFFAOYSA-N	nilutamide
WHXMKTBCFHIYNQ-SECBINFHSA-N	LEVOSIMENDAN
LWQQLNNNIPYSNX-UROSTWAQSA-N	Calcipotriol
JWJOTENAMICLJG-QWBYCMEYSA-N	Dutasteride
YLXDSYKOBKBWJQ-LBPRGKRZSA-N	Ramelteon
BBAWEDCPNXPBQM-GDEBMMAJSA-N	Telaprevir
GVEAYVLWDAFXET-XGHATYIMSA-N	pancuronium
JFXBEKISTKFVAB-AJQTZOPKSA-N	METOCURINE
KJONHKAYOJNZEC-UHFFFAOYSA-N	nitrazepam
QYSXJUFSXHHAJI-YRZJJWOYSA-N	Vitamin D3
ISWSIDIOOBJBQZ-UHFFFAOYSA-N	phenol
QTBSBXVTEAMEQO-UHFFFAOYSA-M	acetate
ZJKNESGOIKRXQY-UHFFFAOYSA-N	ENOXIMONE
QNZCBYKSOIHPEH-UHFFFAOYSA-N	Apixaban
GGXICVAJURFBLW-CEYXHVGTSA-N	latanoprost
LGLFFNDHMLKUMI-UHFFFAOYSA-N	Gentian violet cation
LZPZPHGJDAGEJZ-AKAIJSEGSA-N	Regadenoson
GBBSUAFBMRNDJC-INIZCTEOSA-N	Eszopiclone
XFYDIVBRZNQMJC-UHFFFAOYSA-N	tizanidine
XJGVXQDUIWGIRW-UHFFFAOYSA-N	loxapine
ASMXXROZKSBQIH-VITNCHFBSA-N	Aclidinium
BLCLNMBMMGCOAS-URPVMXJPSA-N	goserelin
NFLWUMRGJYTJIN-NXBWRCJVSA-N	DESMOPRESSIN
SBNPWPIBESPSIF-MHWMIDJBSA-N	Cetrorelix
DEQANNDTNATYII-RRCPSWKPSA-N	Octreotide
MSTNYGQPCMXVAQ-KIYNQFGBSA-N	tetrahydrofolic acid
HNDVDQJCIGZPNO-YFKPBYRVSA-N	L-His
MEFKEPWMEQBLKI-AIRLBKTGSA-O	S-adenosyl-L-methionine
LCTONWCANYUPML-UHFFFAOYSA-N	Pyruvic acid
YBJHBAHKTGYVGT-ZKWXMUAHSA-N	biotin
ODKSFYDXXFIFQN-BYPYZUCNSA-N	L-arginine
CIWBSHSKHKDKBQ-JLAZNSOCSA-N	ascorbic acid
CKLJMWTZIZZHCS-REOHCLBHSA-N	L-aspartic acid
AHLPHDHHMVZTML-BYPYZUCNSA-N	SCHEMBL11234899
ZDXPYRJPNDTMRX-VKHMYHEASA-N	L-glutamine
FFEARJCKVFRZRR-BYPYZUCNSA-N	L-Met
OUYCCCASQSFEME-QMMMGPOBSA-N	L-tyrosine
AUNGANRZJHBGPY-SCRDCRAPSA-N	riboflavin
MBLBDJOUHNCFQT-LXGUWJNJSA-N	UNII-V956696549
RWSXRVCMGQZWBV-WDSKDSINSA-N	glutathione
UNJJBGNPUUVVFQ-ZJUUUORDSA-N	Phosphatidylserine
JWUBBDSIWDLEOM-DTOXIADCSA-N	Calcifediol
RADKZDMFGJYCBB-UHFFFAOYSA-N	pyridoxal
CVSVTCORWBXHQV-UHFFFAOYSA-N	creatine
ROHFNLRQFUQHCH-YFKPBYRVSA-N	L-leucine
QIVBCDIJIAJPQS-VIFPVBQESA-N	(2S)-2-azaniumyl-3-(1H-indol-3-yl)propanoate
MECHNRXZTMCUDQ-RKHKHRCZSA-N	ergocalciferol
RHGKLRLOHDJJDR-BYPYZUCNSA-N	L-citrulline
OVBPIULPVIDEAO-LBPRGKRZSA-N	folic acid
GVJHHUAWPYXKBD-IEOSBIPESA-N	alpha-Tocopherol
LXNHXLLTXMVWPM-UHFFFAOYSA-N	pyridoxine
AGPKZVBTJJNPAG-WHFBIAKZSA-N	(2S,3S)-2-ammonio-3-methylpentanoate
IAOZJIPTCAWIRG-QWRGUYRKSA-N	aspartame
ONIBWKKTOPOVIA-BYPYZUCNSA-N	L-proline
DCXYFEDJOCDNAF-REOHCLBHSA-N	L-beta-asparagine
ALXRNCVIQSDJAO-KRCBVYEFSA-N	AC1L9FJD
SNICXCGAKADSCV-UHFFFAOYSA-N	nicotine
WUTYZMFRCNBCHQ-LHIURRSHSA-N	cevimelina
DIWRORZWFLOCLC-UHFFFAOYSA-N	lorazepam
ZEHYJZXQEQOSON-AATRIKPKSA-N	ethchlorvynol
DHHVAGZRUROJKS-UHFFFAOYSA-N	phentermine
UCEWGESNIULAGX-UHFFFAOYSA-N	INDECAINIDE
TVYLLZQTGLZFBW-ZBFHGGJFSA-N	Tramadol
YOZNUFWCRFCGIH-WZHZPDAFSA-K	HYDROXOCOBALAMIN
AXOIZCJOOAYSMI-UHFFFAOYSA-N	succinylcholine
OYYDSUSKLWTMMQ-UHFFFAOYSA-N	Trospium
LZCDAPDGXCYOEH-UHFFFAOYSA-N	ADAPALENE
PTKSEFOSCHHMPD-UHFFFAOYSA-N	midodrine
UXIGZRQVLGFTOU-PUNKFERVSA-N	Remikiren
NGBFQHCMQULJNZ-UHFFFAOYSA-N	Torasemide
PWVXXGRKLHYWKM-LJQANCHMSA-N	Eletriptan
NIVZHWNOUVJHKV-UHFFFAOYSA-N	Betanidine
GFRUPHOKLBPHTQ-UHFFFAOYSA-N	oxyphenonium
HUYWAWARQUIQLE-UHFFFAOYSA-N	isoetharine
WIGIZIANZCJQQY-UHFFFAOYSA-N	glimepiride
WXURHACBFYSXBI-XHIJKXOTSA-N	diflorasone
HPBNRIOWIXYZFK-UHFFFAOYSA-N	GUANADREL
JPGQOUSTVILISH-UHFFFAOYSA-N	enflurane
QYQDKDWGWDOFFU-IUODEOHRSA-N	cefotiam
SEQDDYPDSLOBDC-UHFFFAOYSA-N	temazepam
CESYKOGBSMNBPD-UHFFFAOYSA-N	methyclothiazide
WUBBRNOQWQTFEX-UHFFFAOYSA-N	4-Aminosalicylic acid
ZRIHAIZYIMGOAB-UHFFFAOYSA-N	butabarbital
QRJJEGAJXVEBNE-MOHJPFBDSA-N	Oxizole
FJXOGVLKCZQRDN-PHCHRAKRSA-N	alclometasone
UZVHFVZFNXBMQJ-UHFFFAOYSA-N	butalbital
PTOAARAWEBMLNO-KVQBGUIXSA-N	Cladribine
XKLMZUWKNUAPSZ-UHFFFAOYSA-N	RANOLAZINE
KPJZHOPZRAFDTN-NQUBZZJWSA-N	Deseril
KORNTPPJEAJQIU-KJXAQDMKSA-N	cabergoline
GZENKSODFLBBHQ-ILSZZQPISA-N	medrysone
HJJDBAOLQAWBMH-YCRCPZNHSA-N	cefmenoxime
JXDFEQONERDKSS-UHFFFAOYSA-N	BETAZOLE
SNBUBQHDYVFSQF-HIFRSBDPSA-N	cefmetazole
XUFXOAAUWZOOIT-JMPDRRIHSA-N	acarbose
VUCAHVBMSFIGAI-ZFINNJDLSA-M	Premarin
MKPLKVHSHYCHOC-AHTXBMBWSA-N	Travoprost
ILKJAFIWWBXGDU-MOGDOJJUSA-N	amcinonide
OYVAGSVQBOHSSS-WXFSZRTFSA-O	Bleomicin
GCKFUYQCUCGESZ-BPIQYHPVSA-N	ETONOGESTREL
LEBVLXFERQHONN-UHFFFAOYSA-N	bupivacaine
SGOIRFVFHAKUTI-ZCFIWIBFSA-N	Tenofovir
UIOFUWFRIANQPC-JKIFEVAISA-N	Flucloxacillin
JUZNIMUFDBIJCM-ANEDZVCMSA-N	Ertapenem
RPLCPCMSCLEKRS-BPIQYHPVSA-N	DESOGESTREL
BJVVMKUXKQHWJK-UHFFFAOYSA-N	TALBUTAL
NAVMQTYZDKMPEU-UHFFFAOYSA-N	Bexarotene
HHJUWIANJFBDHT-KOTLKJBCSA-N	vindesine
ULSDMUVEXKOYBU-ZDUSSCGKSA-N	zolmitriptan
OROGSEYTTFOCAN-DNJOTXNNSA-N	codeine
IVBHGBMCVLDMKU-GXNBUGAJSA-N	piperacillin
WVLOADHCBXTIJK-YNHQPCIGSA-N	hydromorphone
XZWYZXLIPXDOLR-UHFFFAOYSA-N	metformin
KASDHRXLYQOAKZ-KDCWXYOMSA-N	Pimecrolimus
WNMJYKCGWZFFKR-UHFFFAOYSA-N	alfuzosin
IRYJRGCIQBGHIV-UHFFFAOYSA-N	trimethadione
CXOXHMZGEKVPMT-UHFFFAOYSA-N	Clobazam
URXWVWVPMJSAJD-KOORYGTMSA-N	Melengestro acetate
MOYGZHXDRJNJEP-UHFFFAOYSA-N	Buclizine
SEEPANYCNGTZFQ-UHFFFAOYSA-N	sulfadiazine
FNKQXYHWGSIFBK-UHFFFAOYSA-N	tetrahydrobiopterin
GBABOYUKABKIAF-GHYRFKGUSA-N	vinorelbine
HCFDWZZGGLSKEP-UHFFFAOYSA-N	doxylamine
SFLSHLFXELFNJZ-QMMMGPOBSA-N	norepinephrine
RONZAEMNMFQXRA-UHFFFAOYSA-N	mirtazapine
NPPQSCRMBWNHMW-UHFFFAOYSA-N	meprobamate
PAJMKGZZBBTTOY-ZFORQUDYSA-N	Treprostinil
CPZBLNMUGSZIPR-DOTOQJQBSA-N	Onicit
JGMOKGBVKVMRFX-HQZYFCCVSA-N	dydrogesterone
DUDKAZCAISNGQN-UHFFFAOYSA-N	oxyphencyclimine
ZOCKGBMQLCSHFP-ZQUOIQDWSA-N	Valstar
SONNWYBIRXJNDC-VIFPVBQESA-N	phenylephrine
CFOYWRHIYXMDOT-UHFFFAOYSA-N	Carbimazole
DLNKOYKMWOXYQA-VXNVDRBHSA-N	Norephedrine
YRALAIOMGQZKOW-HYAOXDFASA-N	Ceruletide
ZDIGNSYAACHWNL-HNNXBMFYSA-N	Dexbrompheniramine
HTTJABKRGRZYRN-UHFFFAOYSA-N	enoxaparin
GUJRSXAPGDDABA-NSHDSACASA-N	Remoxipride
MINDHVHHQZYEEK-HBBNESRFSA-N	Mupirocin
GNXFOGHNGIVQEH-UHFFFAOYSA-N	methocarbamol
GGXKWVWZWMLJEH-UHFFFAOYSA-N	famciclovir
CBEQULMOCCWAQT-WOJGMQOQSA-N	triprolidine
ZSJLQEPLLKMAKR-GKHCUFPYSA-N	streptozocin
UMMADZJLZAPZAW-OVXHCKHTSA-N	Hemabate
PWAUCHMQEXVFJR-PMAPCBKXSA-N	cefpiramide
MWUXSHHQAYIFBG-UHFFFAOYSA-N	nitric oxide
HDWIHXWEUNVBIY-UHFFFAOYSA-N	BENDROFLUMETHIAZIDE
SDUQYLNIPVEERB-QPPQHZFASA-N	gemcitabine
NRUKOCRGYNPUPR-PSZSYXFXSA-N	Teniposido
AOJJSUZBOXZQNB-VTZDEGQISA-N	Epirubicin
WIIZWVCIJKGZOK-RKDXNWHRSA-N	chloramphenicol
OCUJLLGVOUDECM-UHFFFAOYSA-N	dipivefrin
PGBHMTALBVVCIT-VCIWKGPPSA-N	neomycin
IHUNBGSDBOWDMA-AQFIFDHZSA-N	Acitretin
CXYRUNPLKGGUJF-JIRGPDKYSA-M	Pamine
URLJMZWTXZTZRR-UHFFFAOYSA-N	SCHEMBL11371614
DKLKMKYDWHYZTD-UHFFFAOYSA-N	HEXYLCAINE
NZXKDOXHBHYTKP-UHFFFAOYSA-N	METHOHEXITAL
LKCWBDHBTVXHDL-RMDFUYIESA-N	amikacin
GOTYRUGSSMKFNF-UHFFFAOYSA-N	Lenalidomide
YFAGHNZHGGCZAX-JKIFEVAISA-N	dicloxacillin
FHFYDNQZQSQIAI-UHFFFAOYSA-N	Pefloxacin
BIDNLKIUORFRQP-FKDWWROVSA-N	fosinopril
HXGBXQDTNZMWGS-RUZDIDTESA-N	Darifenacin
NFBAXHOPROOJAW-UHFFFAOYSA-N	phenindione
YQNQNVDNTFHQSW-UHFFFAOYSA-N	NITAZOXANIDE
XUIIKFGFIJCVMT-GFCCVEGCSA-N	D-Thyroxine
HPMZBILYSWLILX-UMDUKNJSSA-N	Acetyldiginatin
MYPYJXKWCTUITO-LYRMYLQWSA-N	VANCOMYCIN
QSFKGMJOKUZAJM-UHFFFAOYSA-M	Octatropine methylbromide
HXHWSAZORRCQMX-UHFFFAOYSA-N	albendazole
VXFJYXUZANRPDJ-WTNASJBWSA-N	trandolapril
LWAFSWPYPHEXKX-UHFFFAOYSA-N	CARTEOLOL
AQCHWTWZEMGIFD-UHFFFAOYSA-N	metolazone
ZDXUKAKRHYTAKV-UHFFFAOYSA-N	Lercanidipine
BJFGVYCULWBXKF-UHFFFAOYSA-M	[3-(carbamoylamino)-2-methoxypropyl]mercury(1+) chloride
ZRALSGWEFCBTJO-UHFFFAOYSA-N	guanidine
XFCLJVABOIYOMF-QPLCGJKRSA-N	toremifene
GJSLOMWRLALDCT-UHFFFAOYSA-N	ADINAZOLAM
BDJRBEYXGGNYIS-UHFFFAOYSA-N	azelaic acid
KNAHARQHSZJURB-UHFFFAOYSA-N	propylthiouracil
ZQDWXGKKHFNSQK-UHFFFAOYSA-N	hydroxyzine
NDTSRXAMMQDVSW-UHFFFAOYSA-N	benzthiazide
XXZSQOVSEBAPGS-DONVQRBFSA-L	Cisatracurium besylate
ZAIPMKNFIOOWCQ-UEKVPHQBSA-N	AC1O6OSE
XEKSTYNIJLDDAZ-JASSWCPGSA-F	Arixtra
JXLYSJRDGCGARV-XQKSVPLYSA-N	vinblastine
VACCAVUAMIDAGB-UHFFFAOYSA-N	sulfamethizole
HDOVUKNUBWVHOX-QMMMGPOBSA-N	valacyclovir
JCQLYHFGKNRPGE-FCVZTGTOSA-N	lactulose
PHIQHXFUZVPYII-ZCFIWIBFSA-N	L-carnitine
BZMKNPGKXJAIDV-VAWYXSNFSA-N	Cinalukast
GLUUGHFHXGJENI-UHFFFAOYSA-N	piperazine
HAPOVYFOVVWLRS-UHFFFAOYSA-N	ethosuximide
BDSYKGHYMJNPAB-YKQIDFLYSA-N	Ultravate
IUJDSEJGGMCXSG-UHFFFAOYSA-N	thiopental
SPBDXSGPUHCETR-CVSKBELMSA-N	Ivermectine
DCSUBABJRXZOMT-IRLDBZIGSA-N	cisapride
BOCUKUHCLICSIY-UHFFFAOYSA-N	cyclothiazide
AEOCXXJPGCBFJA-UHFFFAOYSA-N	ethionamide
WXFIGDLSSYIKKV-RCOVLWMOSA-N	metaraminol
VHYCDWMUTMEGQY-UHFFFAOYSA-N	BISOPROLOL
OVCDSSHSILBFBN-UHFFFAOYSA-N	amodiaquine
ATEBXHFBFRCZMA-VXTBVIBXSA-N	RIFABUTIN
VQASKUSHBVDKGU-UHFFFAOYSA-N	PARAMETHADIONE
QSLJIVKCVHQPLV-PEMPUTJUSA-N	OXANDROLONE
CLKOFPXJLQSYAH-ABRJDSQDSA-N	Baciguent
XDDJGVMJFWAHJX-UHFFFAOYSA-N	clorazepate
NOPFSRXAKWQILS-UHFFFAOYSA-N	1-DOCOSANOL
CUHVIMMYOGQXCV-NSHDSACASA-N	DEXMEDETOMIDINE
JYJIGFIDKWBXDU-MNNPPOADSA-N	INULIN
WBXPDJSOTKVWSJ-CYBMUJFWSA-N	Pemetrexed
XLXSAKCOAKORKW-UHFFFAOYSA-N	Dirigestran
BZEWSEKUUPWQDQ-UHFFFAOYSA-N	dyclonine
XNKLLVCARDGLGL-JGVFFNPUSA-N	stavudine
VVIAGPKUTFNRDU-STQMWFEESA-N	Levoleucovorin
KSCFJBIXMNOVSH-UHFFFAOYSA-N	dyphylline
VOKSWYLNZZRQPF-GDIGMMSISA-N	pentazocine
CSNNHWWHGAXBCP-UHFFFAOYSA-L	MAGNESIUM SULFATE
IMYZQPCYWPFTAG-UHFFFAOYSA-N	mecamylamine
AFCGFAGUEYAMAO-UHFFFAOYSA-N	Acamprosate
JWRMHDSINXPDHB-OJAGFMMFSA-N	FLUMETHASONE PIVALATE
KXRZBTAEDBELFD-UHFFFAOYSA-N	SULFALENE
RWHUEXWOYVBUCI-UHFFFAOYSA-N	NAFARELIN
ZHIBQGJKHVBLJJ-UHFFFAOYSA-N	Histamine diphosphate
RKWGIWYCVPQPMF-UHFFFAOYSA-N	chlorpropamide
FUBVWMNBEHXPSU-UHFFFAOYSA-N	MORICIZINE
NLVFBUXFDBBNBW-PBSUHMDJSA-N	tobramycin
WVPSKSLAZQPAKQ-SOSAQKQKSA-N	ZINC12503149
FCCNSUIJIOOXEZ-SJYYZXOBSA-N	pentosan polysulfate
RTGDFNSFWBGLEC-SYZQJQIISA-N	mycophenolate mofetil
FUBBGQLTSCSAON-PBFPGSCMSA-N	Cefaloglycin
SAADBVWGJQAEFS-UHFFFAOYSA-N	flurazepam
UWWDHYUMIORJTA-HSQYWUDLSA-N	MOEXIPRIL
NXFQHRVNIOXGAQ-OQFOIZHKSA-N	Furadantin
YSEXMKHXIOCEJA-FVFQAYNVSA-N	nicergoline
DRHKJLXJIQTDTD-OAHLLOKOSA-N	TAMSULOSIN
RCKMWOKWVGPNJF-UHFFFAOYSA-N	diethylcarbamazine
UWYHMGVUTGAWSP-JKIFEVAISA-N	oxacillin
RQTOOFIXOKYGAN-UHFFFAOYSA-N	NEDOCROMIL
WOZSCQDILHKSGG-UHFFFAOYSA-N	ADEFOVIR DIPIVOXIL
SEBMTIQKRHYNIT-UHFFFAOYSA-N	AZATADINE
ACSIXWWBWUQEHA-UHFFFAOYSA-N	Clodronic Acid
MFDFERRIHVXMIY-UHFFFAOYSA-N	procaine
WJAJPNHVVFWKKL-UHFFFAOYSA-N	methoxamine
FUFVKLQESJNNAN-UHFFFAOYSA-M	homatropine methylbromide
SNIOPGDIGTZGOP-UHFFFAOYSA-N	nitroglycerin
YXRDKMPIGHSVRX-OOJCLDBCSA-N	Rocuronium
BREMLQBSKCSNNH-UHFFFAOYSA-M	DIPHEMANIL METHYLSULFATE
YXSLJKQTIDHPOT-UHFFFAOYSA-N	Atracurium
JBKPUQTUERUYQE-UHFFFAOYSA-O	(1-methylpyridin-2-ylidene)methyl-oxoazanium
OZGNYLLQHRPOBR-DHZHZOJOSA-N	Naftifine
OCJYIGYOJCODJL-UHFFFAOYSA-N	meclizine
DXVUYOAEDJXBPY-NFFDBFGFSA-N	ZINC04102186
OJFSXZCBGQGRNV-UHFFFAOYSA-N	carbinoxamine
MVFGUOIZUNYYSO-UHFFFAOYSA-N	prilocaine
AELCINSCMGFISI-YGPZHTELSA-N	Jatrosom
PIWKPBJCKXDKJR-UHFFFAOYSA-N	isoflurane
SZQIFWWUIBRPBZ-UHFFFAOYSA-N	ethotoin
UKTAZPQNNNJVKR-DBBXXEFVSA-N	dolasetron
DMJNNHOOLUXYBV-PQTSNVLCSA-N	ZINC03808779
WCUXLLCKKVVCTQ-UHFFFAOYSA-M	potassium chloride
QLIIKPVHVRXHRI-CXSFZGCWSA-N	Mometasonum
NHTGHBARYWONDQ-JTQLQIEISA-N	alpha-methyl-tyrosine
FWFVLWGEFDIZMJ-FOMYWIRZSA-N	Hydrocortamate
JXSJBGJIGXNWCI-UHFFFAOYSA-N	malathion
UVOIBTBFPOZKGP-UHFFFAOYSA-N	propiomazine
VVWYOYDLCMFIEM-UHFFFAOYSA-N	propantheline
MKUXAQIIEYXACX-UHFFFAOYSA-N	acyclovir
LGMLJQFQKXPRGA-VPVMAENOSA-K	Gadopentetate meglumine
DQMZLTXERSFNPB-UHFFFAOYSA-N	primidone
JIVZKJJQOZQXQB-UHFFFAOYSA-N	tolazoline
CEAZRRDELHUEMR-UHFFFAOYSA-N	Garamycin
TVURRHSHRRELCG-UHFFFAOYSA-N	fenoldopam
WYCLKVQLVUQKNZ-UHFFFAOYSA-N	Halazepam
LDMWSLGGVTVJPG-UHFFFAOYSA-N	minaprine
YSXKPIUOCJLQIE-UHFFFAOYSA-N	biperiden
LMOINURANNBYCM-UHFFFAOYSA-N	metaproterenol
XBPZXDSZHPDXQU-UHFFFAOYSA-N	ROSOXACIN
NOOLISFMXDJSKH-KXUCPTDWSA-N	l-Menthol
VDUWPHTZYNWKRN-UHFFFAOYSA-N	cinoxacin
OOBHFESNSZDWIU-UHFFFAOYSA-N	phenmetrazine
DWEQWXSKOHHBNT-SAPNQHFASA-N	Halogabide
YMTMADLUXIRMGX-RFPWEZLHSA-N	CLOCORTOLONE
ADIMAYPTOBDMTL-UHFFFAOYSA-N	oxazepam
UFULAYFCSOUIOV-UHFFFAOYSA-N	2-Aminoethanethiol
ALARQZQTBTVLJV-UHFFFAOYSA-N	Mephobarbital
KWGRBVOPPLSCSI-WCBMZHEXSA-N	PSEUDOEPHEDRINE
IKXILDNPCZPPRV-RFMGOVQKSA-N	dromostanolone
VMXUWOKSQNHOCA-UKTHLTGXSA-N	ranitidine
YXKTVDFXDRQTKV-HNNXBMFYSA-N	benzaphetamine
PAZJSJFMUHDSTF-UHFFFAOYSA-N	alprenolol
MAFMQEKGGFWBAB-UHFFFAOYSA-N	Benzonatate
XWTYSIMOBUGWOL-UHFFFAOYSA-N	terbutaline
YPZVAYHNBBHPTO-MXRBDKCISA-N	loteprednol
DTTVNHWDONBIKE-DVZOWYKESA-N	flupentixolum
XQSPYNMVSIKCOC-NTSWFWBYSA-N	Emtricitabine
JBMKAUGHUNFTOL-UHFFFAOYSA-N	chlorothiazide
MOYKHGMNXAOIAT-JGWLITMVSA-N	ISOSORBIDE DINITRATE
MAEIEVLCKWDQJH-UHFFFAOYSA-N	bumetanide
GECHUMIMRBOMGK-UHFFFAOYSA-N	sulfapyridine
CMHHMUWAYWTMGS-UHFFFAOYSA-N	Oxybuprocaine
BPEWUONYVDABNZ-DZBHQSCQSA-N	testolactone
IMPVZRLKKKXMKQ-SGDOCVTFSA-N	benzylpenicilloyl G polylysine
QTTRZHGPGKRAFB-PAIWTFDUSA-N	Vexol
LFQSCWFLJHTTHZ-UHFFFAOYSA-N	ethanol
ZTVQQQVZCWLTDF-UHFFFAOYSA-N	REMIFENTANIL
HTMIBDQKFHUPSX-UHFFFAOYSA-N	METHDILAZINE
LOUPRKONTZGTKE-LHHVKLHASA-N	quinidine
BPKAHTKRCLCHEA-UBFJEZKGSA-N	Paricalcitol
LKYQLAWMNBFNJT-UHFFFAOYSA-N	ANILERIDINE
VAOCPAMSLUNLGC-UHFFFAOYSA-N	metronidazole
WKEMJKQOLOHJLZ-UHFFFAOYSA-N	Almotriptan
UNFWWIHTNXNPBV-WXKVUWSESA-N	Spectinomycin
SLAYUXIURFNXPG-CRAIPNDOSA-N	CEFORANIDE
JURKNVYFZMSNLP-UHFFFAOYSA-N	cyclobenzaprine
NMUSYJAQQFHJEW-KVTDHHQDSA-N	5-azacytidine
OJLOPKGSLYJEMD-URPKTTJQSA-N	misoprostol
XXEPPPIWZFICOJ-UHFFFAOYSA-N	DIETHYLPROPION
GZHFODJQISUKAY-UHFFFAOYSA-N	methantheline
UUNOBWWOFTYQRY-UHFFFAOYSA-N	hexafluorenium
SWRUZBWLEWHWRI-UHFFFAOYSA-N	cycrimine
WREGKURFCTUGRC-POYBYMJQSA-N	zalcitabine
RWZVPVOZTJJMNU-UHFFFAOYSA-N	Demecarium
DQDAYGNAKTZFIW-UHFFFAOYSA-N	PHENPROCOUMON
VWUXBMIQPBEWFH-LQKBAPIOSA-N	CHEBI:31638
YPBATNHYBCGSSN-VWPFQQQWSA-N	MEZLOCILLIN
WKGXYQFOCVYPAC-UHFFFAOYSA-N	felbamate
AMKVXSZCKVJAGH-UHFFFAOYSA-N	naratriptan
ULFRLSNUDGIQQP-UHFFFAOYSA-N	rizatriptan
ZBGPYVZLYBDXKO-HILBYHGXSA-N	CHEBI:7528
LLPOLZWFYMWNKH-CMKMFDCUSA-N	HYDROCODONE
KIQQMECNKUGGKA-NMYWJIRASA-N	NORGESTIMATE
INWLQCZOYSRPNW-UHFFFAOYSA-N	mepivacaine
HUNXMJYCHXQEGX-UHFFFAOYSA-N	zaleplon
IEJXVRYNEISIKR-UHFFFAOYSA-N	apraclonidine
RJURFGZVJUQBHK-IIXSONLDSA-N	DACTINOMYCIN
ZEKZLJVOYLTDKK-UHFFFAOYSA-N	lomefloxacin
SKYSRIRYMSLOIN-UHFFFAOYSA-N	cyclopentolate
BPZSYCZIITTYBL-UHFFFAOYSA-N	formoterol
UBWXUGDQUBIEIZ-QNTYDACNSA-N	Nandrolone phenpropionate
YUUAYBAIHCDHHD-UHFFFAOYSA-N	Methyl aminolevulinate
LMEKQMALGUDUQG-UHFFFAOYSA-N	azathioprine
AUJRCFUBUPVWSZ-XTZHGVARSA-M	AURANOFIN
XPSQPHWEGNHMSK-SECBINFHSA-N	Frovatriptan
JZUFKLXOESDKRF-UHFFFAOYSA-N	hydrochlorothiazide
HGBLNBBNRORJKI-WCABBAIRSA-N	ciclacillin
IMZMKUWMOSJXDT-UHFFFAOYSA-N	cromolyn
IRSCQMHQWWYFCW-UHFFFAOYSA-N	ganciclovir
VSNHCAURESNICA-UHFFFAOYSA-N	hydroxyurea
QXHHHPZILQDDPS-UHFFFAOYSA-N	tioconazole
VDHAWDNDOKGFTD-MRXNPFEDSA-N	Cinacalcet
NZUPCNDJBJXXRF-UHFFFAOYSA-O	bethanechol
YWXYYJSYQOXTPL-SLPGGIOYSA-N	ISOSORBIDE MONONITRATE
LMJSLTNSBFUCMU-UHFFFAOYSA-N	trichlormethiazide
MBWXNTAXLNYFJB-NKFFZRIASA-N	VITAMIN K1
SGRYPYWGNKJSDL-UHFFFAOYSA-N	amlexanox
XMAYWYJOQHXEEK-UHFFFAOYSA-N	ketoconazole
RFKMCNOHBTXSMU-UHFFFAOYSA-N	methoxyflurane
YOSHYTLCDANDAN-UHFFFAOYSA-N	irbesartan
GXRZIMHKGDIBEW-UHFFFAOYSA-N	ethinamate
OOGJQPCLVADCPB-HXUWFJFHSA-N	tolterodine
MEZLKOACVSPNER-UHFFFAOYSA-N	Deprenil
WGFOBBZOWHGYQH-DKYLXPRQSA-N	RU-0211
YJQPYGGHQPGBLI-KGSXXDOSSA-N	novobiocin
BUJAGSGYPOAWEI-UHFFFAOYSA-N	tocainide
BJOLKYGKSZKIGU-UHFFFAOYSA-N	Echothiophate
JTWOMNBEOCYFNV-NFFDBFGFSA-N	azlocillin
WNTYBHLDCKXEOT-UHFFFAOYSA-N	ACETOPHENAZINE
KMIPKYQIOVAHOP-YLGJWRNMSA-N	Cefditoren
ZJJXGWJIGJFDTL-UHFFFAOYSA-N	glipizide
ILYCWAKSDCYMBB-OPCMSESCSA-N	dihydrotachysterol
HOKDBMAJZXIPGC-UHFFFAOYSA-N	mequitazine
GIUYCYHIANZCFB-FJFJXFQQSA-N	fludarabine phosphate
DBVJJBKOTRCVKF-UHFFFAOYSA-N	Etidronic acid
OBATZBGFDSVCJD-LALPQLPRSA-N	deslanoside
HYPPXZBJBPSRLK-UHFFFAOYSA-N	DIPHENOXYLATE
UCSJYZPVAKXKNQ-HZYVHMACSA-N	streptomycin
QCHFTSOMWOSFHM-WPRPVWTQSA-N	pilocarpine
BLFLLBZGZJTVJG-UHFFFAOYSA-N	benzocaine
CZUMMMDKQYRZDP-JCAXBLPDSA-N	Ventavis (TN)
CVBMAZKKCSYWQR-WCGOZPBSSA-N	DESERPIDINE
XSBSKEQEUFOSDD-UHFFFAOYSA-N	Pentolinium
XRECTZIEBJDKEO-UHFFFAOYSA-N	5-Fluorocytosine
GAGWJHPBXLXJQN-UORFTKCHSA-N	CAPECITABINE
IIRWWTKISYTTBL-SFHVURJKSA-N	ARBUTAMINE
ZCGOMHNNNFPNMX-YHYDXASRSA-N	ZB014486
SIDLZWOQUZRBRU-UHFFFAOYSA-N	methyprylon
KVJXBPDAXMEYOA-CXANFOAXSA-N	Trilostane
CHQOEHPMXSHGCL-UHFFFAOYSA-N	TRIMETHAPHAN
GDLBFKVLRPITMI-UHFFFAOYSA-N	diazoxide
XPFRXWCVYUEORT-UHFFFAOYSA-N	phenacemide
WDVSHHCDHLJJJR-UHFFFAOYSA-N	Proflavine
JLRGJRBPOGGCBT-UHFFFAOYSA-N	tolbutamide
XRCFXMGQEVUZFC-UHFFFAOYSA-N	anisindione
FNPXMHRZILFCKX-UHFFFAOYSA-N	Dermatop
SSOLNOMRVKKSON-UHFFFAOYSA-N	proguanil
UQLLWWBDSUHNEB-CZUORRHYSA-N	cephapirin
NEDPPCHNEOMTJV-UHFFFAOYSA-N	sulfoxone
OWQUZNMMYNAXSL-UHFFFAOYSA-N	diphenylpyraline
WDLWHQDACQUCJR-ZAMMOSSLSA-N	ZINC03776970
JLGKQTAYUIMGRK-UHFFFAOYSA-N	Sertaconazole
XLOMZPUITCYLMJ-UHFFFAOYSA-N	thiamylal
ZRCVYEYHRGVLOC-HYARGMPZSA-N	Gemifloxacin
AAQOQKQBGPPFNS-UHFFFAOYSA-N	Bretylium
VDANGULDQQJODZ-UHFFFAOYSA-N	CHLOROPROCAINE
GSDSWSVVBLHKDQ-UHFFFAOYSA-N	ofloxacin
GOLCXWYRSKYTSP-UHFFFAOYSA-N	Oxyde Arsenieux
ACGDKVXYNVEAGU-UHFFFAOYSA-N	GUANETHIDINE
DDBREPKUVSBGFI-UHFFFAOYSA-N	phenobarbital
XDXDZDZNSLXDNA-TZNDIEGXSA-N	IDARUBICIN
WEQAYVWKMWHEJO-UHFFFAOYSA-N	chlormezanone
SZLZWPPUNLXJEA-QEGASFHISA-N	rescinnamine
SCKYRAXSEDYPSA-UHFFFAOYSA-N	CICLOPIROX
DPYMFVXJLLWWEU-UHFFFAOYSA-N	DESFLURANE
KDLRVYVGXIQJDK-NOWPCOIGSA-N	clindamycin
HCRKCZRJWPKOAR-JTQLQIEISA-N	Brinzolamide
FRPJXPJMRWBBIH-RBRWEJTLSA-N	estramustine
GBBSUAFBMRNDJC-UHFFFAOYSA-N	zopiclone
HPHUVLMMVZITSG-ZCFIWIBFSA-N	LEVITIRACETAM
VWPOSFSPZNDTMJ-UCWKZMIHSA-N	nadolol
GQYIWUVLTXOXAJ-UHFFFAOYSA-N	lomustine
GLLPUTYLZIKEGF-HAVVHWLPSA-N	RIDOGREL
VTMVHDZWSFQSQP-VBNZEHGJSA-N	DEZOCINE
RIKMMFOAQPJVMX-UHFFFAOYSA-N	4-Methylpyrazole
BQIPXWYNLPYNHW-UHFFFAOYSA-N	Metipranolol
CDCHDCWJMGXXRH-UHFFFAOYSA-N	estazolam
NZCRJKRKKOLAOJ-XRCRFVBUSA-N	Rifaximin
FQPFAHBPWDRTLU-UHFFFAOYSA-N	aminophylline
ILVYCEVXHALBSC-OTBYEXOQSA-N	Mivacurium
XBMIVRRWGCYBTQ-AVRDEDQJSA-N	Levomethadyl acetate
PJWPNDMDCLXCOM-UHFFFAOYSA-N	Encainide
QWAXKHKRTORLEM-LINFGICFSA-N	HSDB 7161
DFEYYRMXOJXZRJ-UHFFFAOYSA-N	sevoflurane
NUNIWXHYABYXKF-UHFFFAOYSA-N	bromodiphenhydramine
WSPOMRSOLSGNFJ-VGOFMYFVSA-N	chlorprothixene
KAQKFAOMNZTLHT-OZUDYXHBSA-N	prostacyclin
ZZHLYYDVIOPZBE-UHFFFAOYSA-N	trimeprazine
XKFPYPQQHFEXRZ-UHFFFAOYSA-N	isocarboxazid
LLJFMFZYVVLQKT-UHFFFAOYSA-N	Gliquidone
WPGGHFDDFPHPOB-UHFFFAOYSA-N	145375-43-5
VOBHXZCDAVEXEY-JSGCOSHPSA-N	Lisdexamfetamine
STZYTFJPGGDRJD-FJJJPKKESA-N	Retapamulin
WBGKWQHBNHJJPZ-LECWWXJVSA-N	DESONIDE
XAUDJQYHKZQPEU-KVQBGUIXSA-N	Decitabine
RAGOYPUPXAKGKH-AGDNISCASA-N	NCGC00185736-01
IQFYYKKMVGJFEH-CSMHCCOUSA-N	Telbivudine
JQSHBVHOMNKWFT-DTORHVGOSA-N	Varenicline
IXOXBSCIXZEQEQ-UHTZMRCNSA-N	Nelarabine
NSTRIRCPWQHTIA-DTRKZRJBSA-N	Carbetocin
ZKUDBRCEOBOWLF-UHFFFAOYSA-N	Glisoxepide
VQDBNKDJNJQRDG-UHFFFAOYSA-N	PIRBUTEROL
HXLAFSUPPDYFEO-UHFFFAOYSA-N	Bevantolol
MSWZFWKMSRAUBD-IVMDWMLBSA-N	D-Glucosamine
DURULFYMVIFBIR-UHFFFAOYSA-N	practolol
SIBQAECNSSQUOD-UHFFFAOYSA-N	sulfacytine
PJSFRIWCGOHTNF-UHFFFAOYSA-N	SULFADOXINE
MLBVMOWEQCZNCC-OEMFJLHTSA-N	Fosamprenavir
XWLUWCNOOVRFPX-UHFFFAOYSA-N	Fosphenytoin
XJSFLOJWULLJQS-NGVXBBESSA-N	josamycin
CYLWJCABXYDINA-UHFFFAOYSA-N	polythiazide
AGMMTXLNIQSRCG-UHFFFAOYSA-N	QUINETHAZONE
MLYYVTUWGNIJIB-BXKDBHETSA-N	cefazolin
DYAIAHUQIPBDIP-AXAPSJFSSA-N	CEFONICID
GCFBRXLSHGKWDP-WTKTZPJXSA-N	Cefobid
WZOZEZRFJCJXNZ-ZBFHGGJFSA-N	cefoxitin
NNULBSISHYWZJU-LLKWHZGFSA-N	ceftizoxime
RDLPVSKMFDYCOR-UEKVPHQBSA-N	ZINC03830515
OWWLUIWOFHMHOQ-XGHATYIMSA-N	PIPECURONIUM
BGSZAXLLHYERSY-XQIGCQGXSA-N	Vecuronium
HHHKFGXWKKUNCY-FHWLQOOXSA-N	ZINC03781951
YONOBYIBNBCDSJ-UHFFFAOYSA-N	Forasartan
YHRUERMOPBDCFD-UHFFFAOYSA-N	Quinidine barbiturate
DUEWVPTZCSAMNB-UHFFFAOYSA-N	Saprisartan
HRWCVUIFMSZDJS-SZMVWBNQSA-N	ZINC04217459
ADXGNEYLLLSOAR-UHFFFAOYSA-N	TASOSARTAN
VIROVYVQCGLCII-UHFFFAOYSA-N	amobarbital
UORJNBVJVRLXMQ-UHFFFAOYSA-N	APROBARBITAL
STDBAQMTJLUMFW-UHFFFAOYSA-N	Butethal
PAZQYDJGLKSCSI-UHFFFAOYSA-N	Heptabarbital
UYXAWHWODHRRMR-UHFFFAOYSA-N	Hexobarbital
HBBGRARXTFLTSG-UHFFFAOYSA-N	lithium ion
KQXKVJAGOJTNJS-HNNXBMFYSA-N	penbutolol
KWGRBVOPPLSCSI-WPRPVWTQSA-N	Ephedrine
RXQCGGRTAILOIN-UHFFFAOYSA-N	MEPHENTERMINE
FKNXQNWAXFXVNW-BLLLJJGKSA-N	ZINC19632692
WTHRRGMBUAHGNI-MJWHERSYSA-N	Quinupristin
XAGFODPZIPBFFR-UHFFFAOYSA-N	ALUMINUM
RBNPZEHAODHBPZ-UHFFFAOYSA-M	SCHEMBL9073325
QFWPJPIVLCBXFJ-UHFFFAOYSA-N	GLYMIDINE
MKPDWECBUAZOHP-AFYJWTTESA-N	paramethasone
IAKHMKGGTNLKSZ-UHFFFAOYSA-N	Colchine
METQSPRSQINEEU-HXCATZOESA-N	Drospirenone
MQHWFIOJQSCFNM-UHFFFAOYSA-L	Magnesium salicylate
ABBQHOQBGMUPJH-UHFFFAOYSA-M	SCHEMBL8922293
WVYADZUPLLSGPU-UHFFFAOYSA-N	Salsalate
FQCQGOZEWWPOKI-UHFFFAOYSA-K	CHOLINEMAGNESIUMTRISALICYLATE
VRQVVMDWGGWHTJ-CQSZACIVSA-N	Levomepromazine
LERNTVKEWCAPOY-KYQOMENCSA-N	Tiotropium
LUKZNWIVRBCLON-FOMURGDPSA-N	Alvesco
UAJUXJSXCLUTNU-UHFFFAOYSA-N	ONO-RS 411
YAPQBXQYLJRXSA-UHFFFAOYSA-N	theobromine
HVFLCNVBZFFHBT-ZKDACBOMSA-N	cefepime
RRYMAQUWDLIUPV-BXKDBHETSA-N	Cephacetrile
UNJFKXSSGBWRBZ-BJCIPQKHSA-N	ceftibuten
WYUSVOMTXWRGEK-HBWVYFAYSA-N	CEFPODOXIME
VABCILAOYCMVPS-UHFFFAOYSA-N	ACENOCOUMAROL
NWGGKKGAFZIVBJ-UHFFFAOYSA-N	Antrafenine
UOZODPSAJZTQNH-LSWIJEOBSA-N	paromomycin
KSEYRUGYKHXGFW-UHFFFAOYSA-N	Alizapride
CJDRUOGAGYHKKD-HEFSZTOGSA-N	ajmaline
NZLBHDRPUJLHCE-UHFFFAOYSA-N	APRINDINE
OBDOVFRMEYHSQB-UHFFFAOYSA-N	ALMITRINE
ATXHVCQZZJYMCF-XUDSTZEESA-N	allylestrenol
XBMIVRRWGCYBTQ-UHFFFAOYSA-N	Methadyl acetate
VEQOALNAAJBPNY-UHFFFAOYSA-N	antipyrine
JMBQKKAJIKAWKF-UHFFFAOYSA-N	glutethimide
GVGLGOZIDCSQPN-PVHGPHFFSA-N	Diacetylmorphine
IKFBPFGUINLYQI-UHFFFAOYSA-N	Fencamfamin
OGDVEMNWJVYAJL-LEPYJNQMSA-N	Ethylmorphine
VMIYHDSEFNYJSL-UHFFFAOYSA-N	bromazepam
CHBRHODLKOZEPZ-UHFFFAOYSA-N	clotiazepam
ROYOYTLGDLIGBX-UHFFFAOYSA-N	fludiazepam
MYWUZJCMWCOHBA-VIFPVBQESA-N	METHAMPHETAMINE
MFOCDFTXLCYLKU-UHFFFAOYSA-N	phendimetrazine
QPPBRPIAZZHUNT-UHFFFAOYSA-N	sulfamerazine
ASWVTGNCAZCNNR-UHFFFAOYSA-N	sulfamethazine
LKYWLLWWYBVUPP-XOCLESOZSA-L	Euthroid
PWAJCNITSBZRBL-UHFFFAOYSA-N	KETAZOLAM
MWQCHHACWWAQLJ-UHFFFAOYSA-N	prazepam
IKMPWMZBZSAONZ-UHFFFAOYSA-N	quazepam
HKVAMNSJSFKALM-CYUZEOOHSA-N	Everolimus
XAXMYHMKTCNRRZ-UHFFFAOYSA-N	Cinolazepam
DHSUYTOATWAVLW-WFVMDLQDSA-N	Cilastatin
GUHPRPJDBZHYCJ-UHFFFAOYSA-N	tiaprofenic acid
PFOLLRNADZZWEX-FFGRCDKISA-N	bacampicillin
RJQXTJLFIWVMTO-TYNCELHUSA-N	methicillin
ZEMIJUDPLILVNQ-ZXFNITATSA-N	Pivampicillin
OHKOGUYZJXTSFX-KZFFXBSXSA-N	TICARCILLIN
CSDTZUBPSYWZDX-UHFFFAOYSA-N	Pentyl nitrite
SNFOERUNNSHUGP-ZXZARUISSA-N	CHEBI:60072
NOSIYYJFMPDDSA-UHFFFAOYSA-N	Acetylpromazine
XLOQNFNTQIRSOX-UHFFFAOYSA-N	Acepromethazine
KLPWJLBORRMFGK-UHFFFAOYSA-N	MOLINDONE
IJHNSHDBIRRJRN-UHFFFAOYSA-N	pheniramine
JOMHSQGEWSNUKU-UHFFFAOYSA-N	Pipotiazine
VZYCZNZBPPHOFY-UHFFFAOYSA-N	Thioproperazine
JTPUMZTWMWIVPA-UHFFFAOYSA-O	isopropamide
OJMMVQQUTAEWLP-ISVUEQNNSA-N	Lincorex
SUYRLXYYZQTJHF-FUODUHIRSA-N	Dalfopristina
BENFXAYNYRLAIU-QSVFAHTRSA-N	Terlipressin
IECPWNUMDGFDKC-MZJAQBGESA-N	fusidic acid
LDCYZAJDBXYCGN-VIFPVBQESA-N	Cincofarm
VWWQXMAJTJZDQX-UYBVJOGSSA-N	flavin adenine dinucleotide
JWCSIUVGFCSJCK-CAVRMKNVSA-N	Latamoxef
PWZUUYSISTUNDW-VAFBSOEGSA-N	QUINESTROL
GSNHKUDZZFZSJB-HLMSNRGBSA-N	Maraviroc
WRCHFMBCVFFYEQ-UHFFFAOYSA-N	CHLOPHEDIANOL
WZHCOOQXZCIUNC-UHFFFAOYSA-N	cyclandelate
JWPGJSVJDAJRLW-UHFFFAOYSA-N	Debrisoquine
GKNPSSNBBWDAGH-UHFFFAOYSA-N	mepenzolate
MKJIEFSOBYUXJB-UHFFFAOYSA-N	TETRABENAZINE
FABUFPQFXZVHFB-CFWQTKTJSA-N	Aza-epothilone B
KOHIRBRYDXPAMZ-UHFFFAOYSA-N	Nebivolol
HYFHYPWGAURHIV-ZEDNPHJLSA-N	Ceflatonin
VCMIRXRRQJNZJT-XRMSBCOFSA-N	VOACAMINE
YWGDOWXRIALTES-UHFFFAOYSA-N	TAU-284DS
GAWXLRUZZFSQON-UHFFFAOYSA-N	DB04894
ZXIBCJHYVWYIKI-PZJWPPBQSA-N	Ximelagatran
KPBZROQVTHLCDU-UHFFFAOYSA-N	Clevidipine
RLLPVAHGXHCWKJ-UHFFFAOYSA-N	Permethrin
LUMKNAVTFCDUIE-VHXPQNKSSA-N	Ospemifene
MUTNCGKQJGXKEM-UHFFFAOYSA-N	Tamibarotene
XMXHEBAFVSFQEX-UHFFFAOYSA-N	Iloperidone
KSMAGQUYOIHWFS-UHFFFAOYSA-N	Lofexidine
FBQPGGIHOFZRGH-UHFFFAOYSA-N	LUCANTHONE
VDJHFHXMUKFKET-WDUFCVPESA-N	Ingenol mebutate
AJXPJJZHWIXJCJ-UHFFFAOYSA-N	METHSUXIMIDE
CHPZKNULDCNCBW-UHFFFAOYSA-N	dinitrooxygallanyl nitrate
IWCWQNVIUXZOMJ-MISYRCLQSA-N	Ecabet
KFQYTPMOWPVWEJ-UHFFFAOYSA-N	ent-Rotigotine
VOWOEBADKMXUBU-UHFFFAOYSA-J	Tetrachlorodecaoxide
JNMRHUJNCSQMMB-UHFFFAOYSA-N	sulfathiazole
PWKSKIMOESPYIA-BYPYZUCNSA-N	N-Acetyl-L-cysteine
QURWXBZNHXJZBE-MCDGZUPGSA-N	Icatibant
POGQSBRIGCQNEG-UHFFFAOYSA-N	Rufinamide
KWTWDQCKEHXFFR-SMDDNHRTSA-N	Tapentadol
PNCPYILNMDWPEY-QGZVFWFLSA-N	Silodosin
DTGLZDAWLRGWQN-UHFFFAOYSA-N	Prasugrel
GMDCDXMAFMEDAG-BTJKTKAUSA-N	Sycrest
WEAJZXNPAWBCOA-INIZCTEOSA-N	Avanafil
QXWYKJLNLSIPIN-SFYZADRCSA-N	AC1OE4K8
IYFNEFQTYQPVOC-UHFFFAOYSA-N	Udenafil
PHWXUGHIIBDVKD-UHFFFAOYSA-N	Sitaxentan
NTJOBXMMWNYJFB-UHFFFAOYSA-N	amisulpride
GOADIQFWSVMMRJ-KWQAYMRWSA-N	Forxiga (TN)
UTFVNNPSMPINLE-UHFFFAOYSA-N	SuperVent
XRQDFNLINLXZLB-GKWMMFDUSA-N	AC1L45SI
JUUFBMODXQKSTD-UHFFFAOYSA-N	Flupirtine
NUKYPUAOHBNCPY-UHFFFAOYSA-N	4-aminopyridine
VMZMNAABQBOLAK-DBILLSOUSA-N	Pasireotide
KGWDUNBJIMUFAP-KVVVOXFISA-N	ETHANOLAMINE OLEATE
HUCJFAOMUPXHDK-UHFFFAOYSA-N	xylometazoline
KSGXQBZTULBEEQ-UHFFFAOYSA-N	Dabigatran etexilate
MKKYBZZTJQGVCD-XTCKQBCOSA-N	Arbekacin
UUQMNUMQCIQDMZ-UHFFFAOYSA-N	betahistine
MEUCPCLKGZSHTA-RHCWOGDZSA-N	Firmagon
DCCSDBARQIPTGU-HSZRJFAPSA-N	Fesoterodine
XVQUOJBERHHONY-UHFFFAOYSA-N	Isometheptene
GEFQWZLICWMTKF-CDUCUWFYSA-N	levonordefrin
ISHXLNHNDMZNMC-JCMHNJIXSA-N	Norelgestromin
JCRIVQIOJSSCQD-UHFFFAOYSA-N	Propylhexedrine
ALFGKMXHOUSVAD-UHFFFAOYSA-N	Ketobemidone
OMFNSKIUKYOYRG-MOSHPQCFSA-N	drotaverine
MWTBKTRZPHJQLH-UHFFFAOYSA-N	Alcaftadine
QFFGVLORLPOAEC-SNVBAGLBSA-N	Besifloxacin
BMQGVNUXMIRLCK-OAGWZNDDSA-N	CABAZITAXEL
LCQLHJZYVOQKHU-VKHMYHEASA-N	Carglumic acid
RUDATBOHQWOJDD-BSWAIDMHSA-N	chenodeoxycholic acid
WYQPLTPSGFELIB-JTQPXKBDSA-N	difluprednate
JVLBPIPGETUEET-GAAHOAFPSA-O	Methylnaltrexone
QEFAQIPZVLVERP-UHFFFAOYSA-N	Nepafenac
OGSBUKJUDHAQEA-WMCAAGNKSA-N	Pralatrexate
ODFHGIPNGIAMDK-NJBDSQKTSA-N	Azidocillin
CYFLXLSBHQBMFT-UHFFFAOYSA-N	SULFAMOXOLE
REYFJDPCWQRWAA-UHFFFAOYSA-N	antazoline
MVMQESMQSYOVGV-UHFFFAOYSA-N	DIMETHINDENE
OQJBSDFFQWMKBQ-UHFFFAOYSA-N	Isothipendyl
JKWKMORAXJQQSR-MOPIKTETSA-N	NANDROLONE DECANOATE
HQIRNZOQPUAHHV-UHFFFAOYSA-N	BUPRANOLOL
ZDLBNXXKDMLZMF-UHFFFAOYSA-N	Cinitapride
RUJBDQSFYCKFAA-UHFFFAOYSA-N	tofisopam
PQXKDMSYBGKCJA-CVTJIBDQSA-N	Lurasidone
WSNODXPBBALQOF-VEJSHDCNSA-N	Tafluprost
PURKAOJPTOLRMP-UHFFFAOYSA-N	Ivacaftor
QJFSABGVXDWMIW-UHFFFAOYSA-N	AZILSARTAN MEDOXOMIL
MBBCVAKAJPKAKM-UHFFFAOYSA-N	Lomitapide
YIBOMRUWOWDFLG-ONEGZZNKSA-N	Rilpivirine
ZVGNESXIJDCBKN-KFGPIHIUSA-N	Dificid
BLMPQMFVWMYDKT-NZTKNTHTSA-N	Carfilzomib
KXGCNMMJRFDFNR-WDRJZQOASA-N	Linaclotide
PBAPPPCECJKMCM-IBGZPJMESA-N	Mirabegron
QUIJNHUBAXPXFS-XLJNKUFUSA-N	Bedaquiline
JGCMEBMXRHSZKX-UHFFFAOYSA-N	Macitentan
RYQOGSFEJBUZBX-UHFFFAOYSA-N	Dimetacrine
GIYAQDDTCWHPPL-UHFFFAOYSA-N	bromopride
ANJTVLIZGCUXLD-DTWKUNHWSA-N	CYTISINE
